33,36
368
368
1000
..........e@..ee@e@e..e.e.@eeee@e...
w...@ee@...e..@@@e.@ee@e@.e.@@ee@..w
....e..e......eeee@..e@e....e.@e@e..
..e@ee@ee@..e@e@.@e..........@ee....
w.@e....@e.e.......e.@e@.e@e.e@@.e.w
.......e@e.@e@e....@eeee.e.e...e.@..
......e.e@e@.....ee@e@@ee@.@.....e..
w..eee@e.e.ee...e@eee@@e...e@e..e..w
...@@@e@e@.e@..e@e@@eee....e@ee.@e..
...eee..@@ee@e........@.....e.@.e@..
w...e@..ee..e@.@e@e..ee....e@.e@...w
..e.........@@eee@.e@@e......@eee@..
..@e.ee@e.e@ee..@ee.e..e@e@e@e...e..
w.@e.@@...@......@@ee@...eee@e@e...w
..ee.eee@ee.e..eee...ee@.@@e@ee@....
..@@e..e@..e@..@@ee....e.e@e@...e...
w.e@@e.ee..@@e.e@@@e..e@e...e@..@e.w
...ee@.@e.eeee..eee@..@e..e.@e..@e..
..eee....e@e.@e.e@..ee@@e.@e...ee...
w.@@@e...@e...@.@e.e@@e....@e..@e..w
..ee.e.e@e@...e.e..e@e.....e........
...e@@e.....@e@.@e@e.@e....@e.@e.e..
w...e.@e@.e.e..e@ee.....e..e@@e.e@.w
...e@@e.e.@e@..ee@@..eee@.@eee......
....ee@.e.e...e@@ee..@@e@eee@....e..
w.e@@@e.@e..ee@ee@..@e@e..@e@ee.e@.w
..@ee......e@e.e@e@ee.@ee.ee@e@.@e..
...........e@@.e@e....e.@e@e@e@ee...
w......e.e@.ee....@e.e.e@e.e@.e@@e.w
....ee@@..e.@e....e..@e@ee..e...e@..
..e.@.ee..@e@...e@ee.e..@@e@@e...e..
w.@ee.e.ee.ee.e@ee@@e@eee@eee@...@.w
....@e@e@@e@@e...e@e.e@@ee@......e..