33,36
355
355
1000
......e@@ee....@ee@.....e@e..e@@ee..
w.e@e..eee@....e@.e.e...@@e@e.eee@.w
...e@..@@@e........e@@e.ee@.@@e@e@..
..e....ee.@e......e@eee@@ee.ee@eee..
w.@e.ee@@e...e@...@e@@.e.@@....@@e.w
...@e@@e@..e..e@eeee@ee@.ee....e@e..
..e.ee..e.e@....e@@@e.@.e.@..e@e....
w.@e@@e@e.....ee@.e.e.ee@eee@@e....w
..e...e@e@ee@.@@eee.@ee@e@..ee@.....
..@.eee@..e.e.ee@@@e@@e@e@......ee..
w.e.@@ee.e@e@e@@@ee@e.e@ee..e..e@@.w
..e.ee@e...@.e@ee.ee.......e@.ee@e..
..@....@.e.ee.ee@e@@e@e..e@e..@@....
w.e...eee@.e@e@e@e...e@..e.@.eee...w
...@e.@@e.e@e...e@...@e@e@.e.@e.....
...e@.ee@.e@@e....e@e.eee@e@e@......
w......@..ee@ee..e@...@e.e@eee.....w
......@e.e@e@e@@e...e...e@e@@e......
..ee@eeeee@e.@ee..e@@e...e.e@e......
w.@@e..@@.@e..@e@e@e....e@.e@e..@e.w
..ee@e@ee.e@....ee.@ee.....e@ee@e...
.............e..@@e@e@........e.@e..
w............@e.ee@e.@ee......@ee..w
..e@....e@ee.e...@.@ee@@e@....ee@...
...e.ee.ee@@.@e..e.e@..e.e...e@e@e..
w..@e@@e@@eee@e..@ee@e..........e@.w
....e@ee@e@....ee@e.............@e..
.....e@.e.e.e@e@@e.....e...e@..e@e..
w.e...e@ee@.@e@@e@.ee@e@.e.@e.e@@e.w
..@e..@...e....e..e@.e@@e@e.e...e...
...e..eee@@e...........e.e@.@.e@e...
w..@...@.e.....ee........@e.ee.e@..w
...ee@ee......e@@e..........e@e@e...