33,36
345
345
1000
.........e.@ee@e.e@e@..e@e..e@e.....
w.e@e..ee@.e...@.e@.ee@@e@.e@......w
....e@e@@ee@e@.e.ee...ee..e@.e@.e...
....@e.....@eee@e@@e..........ee@...
w...e@e.ee.ee.@e@@e.......e@..@e...w
....e@@e@@e@@e@eee.....ee..e.e@.....
....@eee@e@..e@@@e.....@@..@e.e.....
w..e.@e.....e@ee@e..e..ee.....ee@..w
..e@@e@...ee@e@.....@e........@@e@..
..@ee..e@e@@e..........e@e....e..e..
w.e@ee@e@e.e.....e@..e@..........e.w
..e.@@e...e@@e.e@@e.e.e.@e..@ee..@..
..@ee@e.@ee@e@.@ee.e@@e.e@@ee@@e.e..
w......eee@@e..e@@e..ee@@ee@ee@@e..w
......e@.e@e....e@e..@@e....@@ee@...
.....ee@e...........@ee..e@.e....e..
w.e.e@@ee.e@.......ee.@e.@ee.eee.@.w
..@.e@e@@e.e.....e@@e..e..e@.@@@ee..
..e.e@..e@....e...ee...@e.e@eee@....
w.@e.e@e@..@ee@eee.@e...@ee@@eee...w
..@e......ee.e@@@@e@e@e@e.@e@e@.....
..ee......@ee.eeeee@ee.e@..ee@e@ee..
w..@......e@@...@e.e@ee@@e@@e@ee@@.w
...e@ee..e@ee.....e..@..e.e.@...@e..
..ee@@@e@.e@@.....@.ee...e..e...ee..
w.@eeee@ee@@ee....ee@.e.e@@e...e@@.w
..@ee@.@ee@e@@e..e...e@..@e.....ee..
..e.@e@e@e@ee@..e@...e@e.e.....e@...
w.@e.....e@e@e..@e.@e.......e......w
..e.e@.@e.....e..@ee@......e@.......
..@e.e@e......@ee.@.e@e....@e..e@e..
w.e@..ee..e@ee.@@.e.@e...e@e@.e.e@.w
.....e@@e..e@@eee..........e@e@.....