33,36
354
354
1000
..e@@e...e@....e@e@e..@e@e......e...
w..ee.....e..@e@@e..@ee...e..e..@..w
.............e@.eee.e.....@e.@e@e...
.............@@ee@@e@e.e.e@e@e.e....
w........e.e.ee..ee@@e.@e@.e@e@@...w
....e..ee@e@@e.e.@e@e@.e..e.e@eeee..
....@..@e@e.ee@@ee..e.e@@e@@e@ee@@..
w...e@ee@@e...e@e...@e.eee@e...eee.w
....e@@@eee...e@ee.e@e.@e@...@e@@e..
..e@.ee@e.@e.ee@e@...eee@....eee@e..
w..e..@...e@e@@.e@e.e@@@..e@e.@ee@.w
......e....e@.e..e..@@ee.......@e...
..e@ee@.e@e@@e.e@@e.ee....e@.ee@ee..
w.e@.e@e.e@@e@..e.....e...@e.@@e.@.w
..@e.e@ee@.e..e..@e...@e....@e...e..
....@ee@e@e..e@e@e@..ee..e@.e@...@..
w.e@ee@.@e..e@.@.....@@e.@ee.....e.w
..e@e..e...e@e.ee.e@ee.....@e.e@....
...@e@e@.e.@e..@@ee@@@e..e@ee..ee@..
w..ee@@e.@ee@..e@@.ee.e@ee@e@....e.w
....ee..e@e@@e@eee........e.@e......
...e@@e...e@e...@e..........ee......
w...e@e.......e@e........@e.e@e@...w
.....e..e.ee...e@.......ee@.e@@e....
....e@..@e@@.ee..e.e@e.e@ee.ee@ee...
w.e.e@ee@e.ee@@e.@e@e@e.e@@.@ee@@e.w
..@e.e@@e....e@.e@.e.e@@e.ee@e..e@..
......e@@e@e.@e..e.@e@@ee@.....ee@..
w..e...e@ee@.@e@e.....e..e....e@.e.w
..e@.ee@.....e...@e...@ee...ee..e...
..@.e@..e@ee@....e@e.e@@@..e@@e@@...
w.e.e......@e@.....@eeeee....e.ee..w
....@e....e@ee......e@@e@...e@e@@e..