33,36
361
361
1000
..@e.....e.e@e@..e@..e...e..e@ee....
w.e..e@.e@.@@ee.e@e.e@..e@.....@ee.w
......ee...eee..@.......e@@e..ee@@..
..e.e..@e....@e@e...e@e@.ee...@e.e..
w.@e@@e@...e@e@e@@e.@e.ee@..ee@@e@.w
..e@.eee.........e......e..e@eee@...
...@e.@e....e.ee...e@...@e@e@@......
w..ee@e.e...@e@@e@eee@...e@.ee..e..w
..ee@...@e....@e.e@@eee@e@e.ee..@e..
..@.e@..e@..e.ee..e@e.e@e@ee@@ee@e..
w.e.@e..e@e.@e@@e.@ee@e.e..e@eee@e.w
..@..@e.@e@e@..@e.e@@e..@...e@@.....
..e@e..e@...eeee...e@e..e.e.e.eee...
w.......e..e@@@e@.ee@.e@e.@.@ee@@e.w
...e.e.....@.e@@e.@ee..e..e.e@@e@e..
...@e@..@e.e@ee.@e@e@..@e...e@e.....
w..ee@e.e.....@e..e@.e@e..e@e@.....w
..e.@e..@e...e.....@e.e@e..e.e@e....
..@e@@ee@@e..@e...ee@.e@@e...e@e....
w...e@@.e..e......@e...ee...e@@e@e.w
...e@ee@...@e@ee...e....@e....ee@@..
..e@...e.ee...e@e@e@.....@.@e.@eee..
w.e@e.e@e@@.e.e@@..@e.@e@eeee.ee...w
....ee..e@e.@e.ee..e@.e..e@@@e@@e...
....@@@ee@ee@e......ee@.e@eee...@...
w.e@eee.@e@e@.e....e@..e@e@@ee.ee..w
...@e..e@e..e.@...........e..@e@e@..
...e@.e@......e.e@e..e...e@e@@e..e..
w..e@@ee...e@e......e@...@e.eee@...w
..e.eee@...ee.@ee@e.@...e@e.e@@e....
..@.......e@@@e.@ee.e@...@e.e@e.....
w.ee@ee@e...ee@e@e@..e.e.e@...@ee@.w
..e@...e@......e@e....e@..e@e....e..