33,36
359
359
1000
..e@e.ee....e@e@....e@e......e@ee@..
w..e@e@@e.@e.e.ee@@ee@e.e@.......e.w
...ee@@ee@eee@..@ee..ee@ee@.....e@..
...@@ee.@e@@...e@e@e@@@.@ee.........
w..e.@e.e..e.eee...@eee.....e@e@e..w
..@ee@.e@@e@e@@@.e@..e@@e...e@e.....
..e@.ee.ee@...eee@e..e.e@...e..e....
w....e@e@e@@e..e@....@......@.e@...w
.....@ee@.eee@e@@e.e.e......e.e@e...
..e...e@e...e@..e..@e@e@..e@@@e.....
w.@eee@.....ee..eeee...ee..eeee@e..w
..@e@e@ee@e@@.ee@@@e...e@e.@.ee@@e..
..e..@.....eee@@.e....e@...ee@.ee@..
w.e..e.....e@e.e....@e@.e@e@.ee....w
..@e...e@.e@e@@e....ee@ee@.e.@@e....
..e...e@e..e..e@e@......@e.@ee......
w.@e..@e@e@@e...@ee......e@e.e@e...w
..@e..@e@@e.....e@@@e...e@@ee@..e@..
..e...e.e..e.ee@@eee...e.@e....e.e..
w....@ee@.e@e@@ee@@@e.e@.ee...e@.e.w
.....e.ee..e@e@.@ee.e....@@e@.e..@..
....eee@@ee@..ee....@....e@@e@@e.e..
w.e@@@@e@@.....@e...e.e@..e..e@ee..w
..@eeeeeeee....e@e@e...e.......e@e..
.....ee@@e@e@e....e@e@e..e@e..e@....
w..e.@....e@e@...ee@.......e...e.e.w
...@ee....@e.e@.e@@e.......@.@e@.@..
..e@e..e@@e@..e....@@e@e...e.ee@ee..
w.@..ee@eee@ee...e.ee.e@.@e...e@e..w
..e.e@@e....@@.e@@e.e@e..e@..e@e@...
....e@@e@...ee..e@@.@@ee....ee@e@e..
w.e.@eeee...e....ee.eee@...e@...e@.w
..@e..e@@e.e@....@e...e@e........e..