33,36
361
361
1000
....e@@ee......ee@e...e@@e.....ee@..
w....ee@@e....e@@e@...@ee@....e@@e.w
..e@e....e.....e@e..e.e@...e.ee@....
.....e@.e@...ee@..@e@e.....@.@.e....
w.ee..e@@e...@e...e..@.....e.e.....w
..@@ee@e@e@.e@.e@....eee.e...@e.e...
..e..@e..@e.@e.@e.e@..@@e@e.....@e..
w...e..e.e.e.@e@e..ee.e@..@e....e@.w
...e@ee@.@e@e@e.....@e.e..@ee@e..e..
..e@@e@ee@e..@e.@e..@e.@..e..@e..@..
w.e@e..@e@eeee..e...e.ee.....e...e.w
..e@e@..ee@@@e.e...e..@e.e@.e..e....
....@eee@..e@ee@.e@@.e@@..e.@e.@e...
w..eee@.....e..e.eeee.ee...e.......w
...@@@e@...e@@e@e@e@@.@ee..@ee......
...eee.e..@e.e@e@@eeeee@@ee@e@......
w..@e.e@e@e......ee@@@e....e.......w
..e@.e@@e.e@e@....e.e....e@..e.@e...
..ee...e...e@e..ee@......ee@e@ee.e..
w.@e....eee@.@e@@.@e@e...@eee@@ee@.w
..@e@e..@@e@ee.eeeee...@e@e..e@@e@..
..e.e@.ee.e.@e@e.@@@e..e.....@e@ee..
w.ee@@e@.e@@e.e@.ee....e......e@ee.w
..@..e...@ee..@e...e...@e...e@@e@@..
..e..ee@ee..e@@ee@e@e@ee.e@e.e...e..
w....@@e.@e..ee.e@.@e@e@ee@e@e..e..w
...@ee@..@e.e@@e.e@e.e@e@.@e....@e..
...e.@e..e..ee@e..@e@e@e..e@....e...
w...e@.e...e@e@@e.e.......@.....@..w
.....ee@@e....ee@.....e...e...e@e...
...@ee..ee@e@e@.e@ee.e@.ee..@ee.....
w.ee.@e@.@..@ee@@@e@e@ee@@e.ee@..e.w
..@e...e.e..e@.eee@...@e@e..e@..e@..