33,36
362
362
1000
..e@e@e........ee@@e....@e.e.....e..
w.eee@@e@.e@ee@@@ee@....e.e@....e@.w
..@e.e..e.e@@@ee....e@e.@e@@e....e..
...e....e@eee@ee@e..@e@..e@e....e@..
w.e@..ee@.e.e@e..e....e@e.......e@.w
..e@.e@@e@@.e@..e@e@...e@.e@e@e@ee..
..@e.....eeeee@.@e.e@e@@...e........
w.@e.e@eee@@@ee.e@....ee..e@..ee.e.w
..e..ee@@..e@e@@e......@e..e@e@@e@..
....e@..e@.@ee@ee..e@ee..e.@e@.e.e..
w...e@e.@e..@ee@@e....@e.@@ee@e@e@.w
..e.e.@e@e........e...e..ee.ee@.e@..
..@e@e@e.eee@e....@e.e@e....@e...e..
w.......e@@e.....e@e..e@..e@e...ee.w
..............@e@@e...e@e..e@...@@..
..e@e.........e.e@@e.....e@e@...ee..
w.e@e.e.e@e.@e...e..e@e...e.e..e@e.w
..e@@.@.e.@ee..ee@.e.e@...@e.....@..
..eee@e@@ee...e@@ee@e.....@e.e@e.e..
w.@@e@.e@e@...e@@ee@@e....e@....e..w
..ee.eeee@....@ee..ee@@ee..@e...@e..
..@...@@e@e..e..@.....ee@..e@e.e@@..
w.e...e......@e.e@ee....e.e.ee..ee.w
....e.e@e..e@e..@ee@...e@.@ee@e.....
..@e@e@e@......e@e@e@e.@e.....@e@e..
w.e.ee@....e@e@e.@@e....e@..eee@e@.w
....@ee.@e..@e...ee@....@e.e@@eee...
..e@e@e@e.e.e.....@@e..@e@.@e@e@@e..
w......e..@ee@.e..ee...e...ee@ee@@.w
...e..e@e@@e.e.@....e@e@..e.@e..ee..
..e@.e@e@ee....ee.e@eeee@.@e.e..e@..
w.e..e.........@@e@...@@e..ee@e.e..w
..@e.@e...e@e..e@e..e@e...e@ee@e@e..