33,36
354
354
1000
..e@e@....eeee@ee......e......ee@e..
w..e.ee@ee@@@@@e@......@.....e@@e..w
..e..@e@.e@eeee@@ee@.eee@e.e@e.e.e..
..@e@e@e.e..e@@.ee@ee@@@ee.@e.e@.@..
w.e.@e...@..@eee.@eee.e@@@ee@.e@ee.w
..@@e....e...ee@e@e@@e.ee@@@e@e@....
..ee...e@e.ee@@@eee@e....ee.e@ee....
w......e@ee@..ee...ee@e...e.....e..w
..@ee.e@...@e......@......@ee@ee@e..
..e@@e@@e..e..e@...e...@e..e..ee@@..
w.e.e@.ee@e...@e.ee.@e.e..e@@e@.ee.w
..@....e@.@..ee@e@@.e@.@..@eeee.e@..
..e.......e.e@...@e....e....e@@e....
w....@e.@e@......e@@e@......e@e..e.w
..e@.e.ee@@e.e..e@@e.e..........e@..
..@e...@..ee@@e.e@e.................
w.....ee..e.ee@@e.ee...e...@e.e....w
...e@e@...@ee@.e@e@@e@e@.e.e..@.....
....e@........e@@e@eee@e@@ee.@e.....
w..e@e@e@eee..@.e..@@e.ee..@ee..e..w
....@e@e.e@@..e@eeeee@.@e...e@..@e..
...eee@e@e.e@e.e@@@..e@e....@..e@...
w.e@ee@@....e....ee.eee.ee.@e...e@.w
..@ee@ee..e.@e...eee@@@e@@.e.@ee.e..
..e@@e@@..@e@e.ee@@..e.@ee@..e@@e@..
w...@e@e.eee@ee@..e.e.@e.@eee@e....w
....e....@@@@e....@e@.e.eee@@e@.....
.....e.e@eeee..e@@e@..e@@@@@ee@e@...
w...e@.e@e@.e@..ee.....eeeee@ee.e..w
..e@@e..e@.e@e...@e.e@.......@ee....
...e@e.....@..e..e@..e..e......@....
w...e@.....e.e@..e@.....@......ee..w
...e@e............e@e...e......e@e..