33,36
355
355
1000
..e@e....e@e.e@.e@.@ee.........e@e..
w.e@@e.....@e.e@.e.ee@e@........e..w
...e....e...e@ee...@e..e.e@ee..e@...
..e@.e@e@@e..e@@e.e@...@e.e@@ee@e...
w.@...ee.e.@e.e@e@.e....e@...e@@e..w
..e...e@e@ee..e@.e@...e@.e..e@ee....
..e.......@e@e.e@.e@e..ee...e@@e....
w.@@e.....e..e.@e.@e@..@@..eee@.e..w
..ee....ee..e@e@..@e...ee.e@@.e.@...
.....@ee@@@e@e@e..e@...ee@e@e.e@ee..
w....ee@.ee.........e.e@e@e...e@e@.w
......@@e@....e..e..@e@@e@@e@ee@ee..
..e@e.ee...e@e@.e@...e@e.e@..@@ee@..
w.@...e..e.@e.....ee.@e..@e..ee@...w
..e@.e@e@@e.@e...e@@e@@e......@e@e..
...ee@e.e.@ee.e@...e.e@...e@...ee@..
w.e@@e@@e.e@@e.e@.e..@e...@e.e.@e..w
..e@@e.e.@e@@e.@e.@....eee@@.@e@e...
...eeee.ee@ee...e.e....@@eee.e.@ee..
w.ee@@@e@@@e@.e@@.@..e@e.....@.ee@.w
..@e@e.@eee...eee.ee@e.....eeee@e@..
..@ee@.e@@...e@..@e..@e...e@@ee@ee..
w.e.@e...ee..e@e.e..e@......e@.....w
..........@..e@e.e@e.e@e....e...e...
...@e.....e@ee@e....e@@e...e@ee.@...
w..ee.@e@..e@e...e.e@.e...e@.e@.e..w
....@ee.ee.@e@.ee@..e@e@e...@e......
..ee@@..e@e@...@e@@e@...@...e....e..
w.@@ee...eee..e..ee@e...e.e@e....@.w
..e..e.e.@@@ee@....e@.e@e..e@e@..e..
....e@.@eee..e@e.@ee@e.eeee@..e.....
w.e@@e@e@e@......e.@ee.@@@e....e...w
...e....e@.........e@@eee.@e...@e...