33,36
348
348
1000
.....ee....e@e...e@....e@..e@e......
w.e.e@@.e..e@ee@.ee@e@e.e@.........w
..@.e@e.@@e....ee@.ee@e..e...ee@e...
..e.e@e@ee...e@e@..@@e.e.e.ee@@e....
w.e..e@..@....ee@e.e@@e@.@e@.ee@.e.w
..@e@e@e.e.e.e@e@...e.e@ee@ee@@e.@..
..eeee@ee.e@e@@ee....e@@e@..e@e..e..
w.@@@..e@.@e..e..e.@e..e.e@e.e@....w
..eee..e@ee@e@e.e@@e...e..ee.@e@e...
..@e.e.e@e..@e@.e@e...e@.e@@..e@@e..
w..e.@e@@e......@....e.ee..e...e...w
...@.ee@e.......ee...@e@@e@e........
...e.............@..e@@e.e@.........
w.e@.e@.......e@.e...e....e..@e....w
..@e..eee@..e@@e...eee.......e......
...e@..@.e@e@e....e@@@e..........e..
w..@e.@e@.e@@e.....@ee@...e@e..e@@.w
......e.ee..e.....ee.e...e@e@e..ee..
.....e...@e.....@e@e.@e@e.@e@@@e@@..
w..e.@e@e.@ee@.eee@@e@e...e.eee..e.w
..e@ee.......ee@@@ee@@e@e...e.......
...e@@e@e.....e@e.e..e@.@..e@.......
w..@ee@@e...e@ee.e@...e@e.e@@e.....w
..e@ee.ee@e.e@.@e@.........@e@......
..@e@@eee@@..e.e......eee@ee.e@.@e..
w....e@@.ee..@e@....e@@@e@e..@e.e..w
..@e..@e.e...e@e.@e.@ee@e..e..@e@...
..e@..e.e@..e..@.e....e@eee@e.e.@e..
w.e@e@.....e@e@e....e..ee@@e@...e@.w
..e@eee.e@..e@.e.e@e@..@@@e.@ee@e@..
..e@@e@@ee..@..@e@@e@e.eee..e..e.e..
w..e..ee@e@ee...e.e@@ee@e@..@e.@e..w
.....e@...e@...e@e@.e.@e.e@e@e......