33,36
355
355
1000
..ee.e.e@e.e@e..e..e@.e@e@..........
w.@@e@e@ee.e@e@e@...e..e.e.........w
..eee@@.@@e@..e..e@e@...e@..@e......
....eee.e@e.e..e..e@@ee.....e...e@..
w.e@@.@e@e..@@e@....ee@..........e.w
..@ee.@e@@e@eee@e.@e...e@@e.....ee..
...@e@e.ee@@e...e@e....eee.e...e@@..
w...@......e.@e..e@..e@@ee.@ee.e@e.w
....e.......@ee@...e@ee..@ee@@e.....
..e..e......e@@e.e.e@@.ee@e..@e.....
w.@e@@........e@.@e.ee.@ee@e@ee@...w
..e@ee@e...e..e.........e@@e@..e.e..
..........e@ee@......e.e@@e@ee@..@..
w.e@.e@e@e..@..e.....@e@ee....e@.e.w
...e@@@ee.@eee@@e.......@@e....ee@..
...@eee.@@e...e......@e.e@e@e..@e...
w.e..@e.eee.......e@ee.ee@.e...@e..w
..@e.e@@ee@@ee@e......e@@e@@e..ee@..
...ee@eeee@e...@@e....e@..eeee@.@e..
w.e@@ee@@@....eee..e...e..e@@.ee@e.w
..e@@eeeee@e..@e..e@......@ee@@e....
..@eee@@@...e..@e.....@e@e@..e......
w...@.eeee@.@e...@e.eee..@e@.......w
..e.e.@ee.ee.....e@e@@e@e@ee........
..@eee@e@..@...e...@@e.ee@..ee@ee...
w.e@@e.e@e@e...@e.eee.e@.e..@.ee@..w
...ee@.ee@.....@ee@.e@@@eee.e@@@....
..e@..e@@e.....e@...@eeee@@@eeee....
w.e@.ee@e@......e...e..@e@eee..ee..w
..@e@@@eee@..e..@e..@..ee@.e@..@@e..
...eee@e@.e@.@.e@@..e...@ee@...e....
w..@e.e.e..e.e..ee@e@.e@ee.......e.w
...e@e@.@e.@e.....e...e@e@.e@e..e@..