33,36
356
356
1000
...e...e@e....e@@ee@..e@e......e@e..
w..@e..e@e.....ee@.e..e@@ee@e.@ee..w
..e@@e@e@@e@e....e@ee@@e.e@...ee....
...e@.e@ee@e.....e@e@e.@.......@e@..
w...e.e@@e@@e...@e...e@e.@e@ee@..e.w
..e....e..e@e..@e@.e.e...e@.e.eee...
..@e..e...e@@e.e...@.@......@.e@@e..
w.@e..@e@.@e@@e....e.eee....e..e@..w
..e..e@ee@e.e@e@e....e@@@eee....e...
..@ee.......@@ee@@e@e..ee.@@e....e..
w.@e@.e@.e..ee.@.e@e......ee@eeee@.w
..e.e.ee.@..e..ee@.@e......@ee@@e...
....@e@e@e.e@@e@@ee....e@e..ee@e....
w....e@@e..e@e...@@..e.e@e..@.e@...w
..ee..e.@e...e@..ee..@.@e@..e..@e...
..@@e.@.@e.e@.ee....eee@.e@.@eee....
w.ee.@eee.e@e.e@...e@..e..e..e@....w
..e@ee@@..eee@e@e..e@e.......e@ee...
...e@e@ee@@ee@@e..............e.@...
w..@ee@e@ee@.e@@e....e@..e@e@.@ee..w
..e.@e...@....e...@e..e@.e@ee.e.....
..@..@.e.e......e@e@.eee.e@@e@@.....
w.ee@e.@e.....e.....e@@e..ee@ee....w
....e.....e..e@@ee..@@ee.e@.........
..e@@....e@e@.@e.@e.ee.@ee@e....e@..
w..eee@e.@e.e@e.......e@e..@.....e.w
..e@@.e@........e@....@@e@ee..e.....
....e@e@e.......@e.e..eee.@.e@@e@e..
w...@.@@ee.....e..e@..ee@.e..eee@e.w
....eeee.@e.e@e@..e@ee@@e.@e..e.....
...e@@e.e@e@e..e@.@eeee@e.@e..@e@e..
w..@eee.e@@..e@@e...@@ee@.e@.ee.e@.w
..e@e@@e.ee...e.....e@ee@e@ee@@e@...