33,36
368
368
1000
..e@e@.....e..@e..e@eee....e.....e..
w.ee.ee...e@@eee.e..e@@e...@@e..e@.w
..@..e@@e.e@e..@e@..@e@@...ee...e@..
..e.e.@e...e@.@e....e.eeee..e.e@@e..
w...@ee@.ee@e.ee@e.....e@@ee@..eee.w
..ee@e.e@@@@e....@ee....e@e..ee.@@..
..@e@e..eeee@.e@e.e@.ee.@e@..@@eee..
w..@...e...e....e.e@e@@e@e...e@....w
..ee@..@e..@.e..@e@e@eee.@e.e.e.....
..@ee.e@e..ee@..ee..e@e@e@e.@e......
w.....e@...@@e..e@e...e@ee@e@@ee@..w
......@e...e@@e.e@@ee@e.e@@ee...e...
....e@e@.e.@e@@..e.e@@e@@ee.e.......
w...e@e..@...ee@eeee@eee....@e@e...w
..e......e.....e@@@ee@@.ee...ee@....
..@e...........e.e@.e@ee@@e@.@e@.e..
w....e..e..ee@e@..e@@e.e@e.ee@eee@.w
...e.@ee@@e@@e.....e.e@e.ee@e@..e@..
...@..e@@e...............@@.@e.e.e..
w.@e@e@@e.e@e..eee@......eee...@e@.w
..e.e@.e..e.e@e@@ee.ee.e@e.@e..e@e..
....@.ee.e@.e@..@ee@@@ee@e.e@.......
w..ee.@@e@e..e..e..ee...@e.@e...ee.w
..e@..e@.e@..@e.eee.....e.e@@e@e@@..
..e@@e@e@@..e@@e@@@.ee..@..e@e.e.e..
w..eee.eeeee.e..@eee@@..e.....e@...w
.....@.@e.@@..@ee@e@.e....@ee.e.....
.....e@e@.ee@ee....e@e.e.@ee@.@e....
w.e@@e......eeee@..@.ee@@e..@e...e.w
..@ee....e@e@@@ee.ee.@e.e.e.e@..e@..
.....e@...e..e@ee@@ee@e@ee@..@e.....
w.....e..ee......e.@....e@e..e.....w
.....e@.e@@e@ee@e..e....@e....e@e...