33,36
349
349
1000
..eee@e......e@e@e.e@@e...e@e....e..
w.@@ee..@e...e@ee@.eee.ee...@ee.e@.w
..e..@eee...e@@e@e.@e..@@e....@ee@..
.....ee@....e@e.e@e.e@ee@ee@ee...e..
w.@ee@.@e...@@e.@e.e..e@e..@e@e....w
..ee...ee@e.eee@e..@e.e@@e.e.e@@e@..
...@....@e@..@..@e.....ee@.@e..e.e..
w..e.e@e....ee@e..e...e@@e..e@e....w
..e..e@@.@ee@e....@e.eee@e..@e@.....
..@e..ee.e.e@@e......@@e.....e@e....
w.@e@e....eee@e@e....ee@..e@e@.@...w
..e@.@e..e@@e....e@e@e@.@e.e@e.e....
...e.@e...e@e..e...@e@e@e...e@......
w..@ee....@@e@e@@e.e.eeee@e.e@e@e..w
...e@@.@e.ee.e@eee@.e@@@@@e..ee@@...
..ee@e.e...@e@.@@ee@e.eeeee...@eee..
w.@@e@...ee@e..ee@..@e@...@eee@@@@.w
..ee.e@ee@.e..........@e@e@@@@eeee..
...@e@e...e@....e.e...e@.@eee@e@....
w..e@.@........e@e@@e@e....e...e@e.w
..e...e........@e..e.....e@@...ee@..
..@@e..........e@...e@....eee..@....
w.ee@.ee.......@....@e..@ee@@eee.e.w
..eee@@@.e@e...e...e@..@e.@e@@@@e@..
..@@.eee.@e....e.e@eee@e@...eee@e...
w.ee@@e@@e@e.e@@e..e.@e.........e@.w
....ee@.ee.@e.e...e@e.......e@e..e..
...e.@@ee@ee.....e@e@.......e...e...
w..@eee@..@@.......e@e...e@e@...@..w
....@ee.@eee.......@e...ee@@@e..e...
..e@.e@.e.......e@ee@...@eeee@..@e..
w.@e.@e......e.....@........e@@ee..w
.....e@e@e@e.@e@e..e.........eee@...