33,36
364
364
1000
..e..e.e.e....e@......@ee@e@e.e@e...
w.@..@e@.@...@ee@e..eee..ee@e..@e..w
..ee@@e..e..eeee@@.e@@e.e@@e@.ee....
..e.ee.....e@e@@eee......ee..e@@e...
w.@........@e@.e..@e@e..e@...e@....w
..e...ee...e..e@.......eee....e.....
...e@e@@ee@...e@ee@e...@@@e.........
w...e@@e..e..@e.e@@e..eee@e........w
.....@e..e..@e.eeee..e@@@@e.........
..e@ee...@e.e.e@@@e...eeeeee@.e.e...
w.@e@@e@e.ee...@e.....@@e@@.e.@e@..w
..e...e..e@@e@eee@..e.ee..e..e@@e...
..@...@e.eee@@e.@e.e@e@@e....@ee....
w.ee.e@e@@@e@eee..e@e@..@e.e..e@e..w
..e@e@@eee@e@.@@ee@ee..@e.e@..@e.e..
....@ee.@.e.eee@..e@@e.e.e@..e@e.@..
w..e....e...e@@e..@e@..@.......e.e.w
...@.......e@e...eeee..e...e...@e@..
...e.ee...e@e...e@@@@..e..e@....e...
w...e@@e....@e.e.@eee..@....e@e.@..w
..e@e@eee@....e@.ee@@@ee........e...
..e@e@e@.e...e.e.e@eee@@e@e.e@e.e...
w..ee@e@.e@..@e@e@e@e..e..@ee@@e@..w
...@e@ee..e...@e@...@e.e@e@.@ee.....
...e@...e@.e..ee@eee..@e.@e.e@@@e...
w..@@e..@e@@e.@e@@@@.@ee@e.@eeee@..w
...ee.....ee@e@.eeee.e..e..e.@...e..
..ee...e.e...@ee@......e@..e@e..e@..
w.@@.ee@e@e@.@e@e...e@...e@....e...w
..ee.@@.e..e@e.e@e...e....e..e.@....
..@e.ee.@..@e.ee@@eee.....@ee@.e....
w.@e.ee.e@..ee@.e..@@...e@e...ee@e.w
..e.e@@e.e@e@@e.@e.eee@e.e@...@e@e..