33,36
361
361
1000
..e@ee@ee.e@e...e@@eee.e..e..e@.e@..
w..@ee@e@@e@@e...ee.@@.@.e@e@ee.@e.w
...e.e@eee.e.e@e.ee@ee.e.e@@@e......
...e.e@e@.e@e@.@e@@e.e....eee..ee...
w.e@..ee@e@e@ee@....e@....e...e@@e.w
..e@@e.......@.ee@ee.....e@....e@...
..@ee.e@.....e@.e@@@e....@e.....e...
w...e@ee......e@.eee@@e.e@e@.e..@..w
....e@e.e@e@..@e.@e.eee..e@e.@e@e...
..e@e@e...@e........@.@..@e@..e.....
w.@ee@@e..@e........e.e..ee..e@@e..w
.....e@@e.e.e@e.......@ee@@e.e@e....
..e@e@e...e............e@@e..e@@e...
w.....ee..@e...e@ee.ee.@@e.e..eee..w
.....e@@.....eee@e@e@@.ee@.@.e@@@e..
..e@e..e.e@ee@@ee@@e@e..@e.e.@ee@e..
w....e.@e@@e.@e...e.e...e.e@e.e@...w
..e.e@..@ee..e@......ee@@eee@e......
..@e@....e.e@ee.e@ee.@@e.e@@ee......
w..e@e...@e...@ee@e@.e@@e@@e.@..@e.w
...e@e........@eee@@e.ee.ee@.e..e...
...e@ee.......ee@..ee..@e@ee.e@.....
w..e@e@....e...ee@e@@.....@@e.e..e.w
...e@.e@ee.@e.e@@e..e.e...e@ee@..@..
...@ee..@@e@e.@.@e@.@e@..@e......e..
w..e@@e.ee.@e.e@e.e.eee@ee....e@e..w
......@...ee....e@e@.@@e@....ee@e...
......e.e@@e@ee@..@e.e..@e@e.@e@e...
w..e.....eee..@ee.....e@e@@e.......w
..e@e@e.e@@@e..e@........@ee@e.e....
..@e...e..ee@@e..........e..e@.@e...
w.eee..@e@@@@e.e..e@e.......e@e.e..w
..e@@ee@eeeee@e@e@e.e@e......e@e@e..