33,36
365
365
1000
....e@.@ee...e@ee@e..e@e@@e...e@@e..
w....e.e.@e...@ee@e..@e.ee....eee..w
..e........e..e.e@......@ee.ee@e@...
..@e.......@.....e...e@ee@@e@e@@e@..
w.....e@e..e.e@..e.@e....@e@@eee.e.w
..ee..@e@.....e.e@eee@e..e.@ee@e@@..
..@@e............e@..e.e@e.e@.e@ee..
w.e@e@...ee@e...e@..e@@ee@.@.e@.e@.w
..e..e...@e@ee@e......e@e@ee.e......
..@..e...@e..e@@...@e.....e@.@e.....
w.e..@e@.e.ee@ee@..e@...@ee@e.@.e@.w
..e..e.e.@e@@.@.e..ee@e.e@.e@ee..e..
..@.....e@..e@e@e@e@.......e.@@e@e..
w.e@e....e@e.@ee@@e........@ee@e...w
...e@...e....ee..e.@e@...e@@ee@ee...
..ee....@e..e.@@e..e.ee@e@ee.@e.@...
w.@@..eeee@e@.ee@......ee.......e..w
..ee.e@@@@e...@ee@ee@ee@@e.e....@...
..e@.e@ee.........@....@e@e@@e@eee..
w.e@eee@...e......e@...e.@e.ee@e@@.w
..e@.@e@e..@e..e@e.e.eee.e..e@e.@e..
...ee.e@ee@e....@ee@e@@@e.e..e@ee...
w.e@@e...e@.e@.@e.e@e.e@e.@e..e@...w
..e@e@..eee..e@e.e.e@.e@e....e@.ee..
..ee...e@@@@e@...@e...@ee....ee.@@..
w.@e.....eeeee..@e@.....@e@..@@.ee.w
..@ee......e@@e.ee@.e.e...e..eee.e..
..e.@..e.e@ee....ee.@e@..ee@.e@@e@..
w..eee@@e..e@.e@e@@ee.e@.@.e.e@@e..w
..e@@ee....e@eee...e@.@e.e...@ee....
..@.e...e@e@.e@....@e.e@...e@@e@....
w.ee@@e.@ee@@e@e....e@@eee..ee.e.e.w
.....e....@ee.....e@ee.e@@e....@e@..