33,36
367
367
1000
..ee..@e....e.@ee..e@e.e@e.e@e......
w.@@..e.....@ee@@e.e@.e@e@.@@e..@e.w
..eee.e@e@.......e@eeee..@eee..ee...
....@e@..e.ee@e.....e@@e.e.e..e@@e..
w....e.e@@.@e@.e..e.@e@....@.......w
.....@eeee..eee@e.@e@.e....ee@.e@...
...@ee@@e.@e@ee@@ee@ee.@e.e..e..e...
w..e..e.e.eee@.e@e..e@ee..@....e@e.w
.....e@.@e.@.......e@@e@e@ee@..@....
...e.......e...e...e@e..e...e..e....
w..@e@ee.......@e@.e@...@.e@eee....w
..e....@e....e@.@e..e..@e.e@e@@e....
..@e..e@e..@eee.e....eeee@eee@.@e@..
w..eee.ee..e@@e.@..e@@@e@@e..eee.e.w
..e@@@e@@e.@@e..e@.@eee@ee..@e@@ee..
..@ee.e@ee.ee....ee@.e..@..@e..e@@..
w...e..e@@e.@e.ee@@ee@..e@eee.e@.e.w
..e@@e..e@e.ee.@e@e.....e@ee@@e..e..
..@e....@ee@@@eee@@e@...@e.@ee@.e@..
w..ee...e@eeee@e.ee@e..e@e.e@...e@.w
...@@.e.@@e@.@.e@e@e..e@e@...ee..e..
...eee@.ee..@ee@@ee@........e@@.e@..
w..ee@...e..e...e@@.ee........e....w
...@@@e..@........ee@@e..e@e........
...eee...e....e....e@@e..e@e..ee....
w..@.e........@e.e.@ee.e@.e..e@@ee.w
...e.@@e.......e@@..@.@eee@.ee@e@@..
....eeeee@e.....ee.ee@e.@..e@@@eee..
w...@ee@@ee@..e@..e@e@@ee.e..ee.@@.w
...e@@.@e.@e..@e..e@@e..@e@.@ee@ee..
...@ee.e@.....e@e.@e.e..e...e@e@e@..
w...e@....e@e.e@@e..e@ee@......ee@.w
......e@e.e@e@ee.....e@e@e.......e..