33,36
359
359
1000
..e@..e.e@e.@ee@@e.e......@e.e.ee...
w.eee@@e.e@ee..ee..@e@....e.e@.@@..w
..@e.e.@e..@e..e..e@@e...e@...eee...
..e...........e@@e.eee@eee@e..@e....
w.@e....e@..e.@.e@.e@..@@@@e.ee....w
...e....@e.e@.e....@e.@eeee.e@@e....
...@e@e...e...ee....@ee.@e.e@e@ee...
w........e@...@@..e@....ee@e...e@e.w
..e..e@e.e@e@.ee..@ee@e@@e@@e..ee@..
..@ee....@e@e.@@e@e.e@ee@.e@..e@@e..
w.@e@.@e.ee...ee@e@e@e..e.@e.......w
..eee@e...@e@ee@@e@@@e@ee@e.e@e@....
...@e@e.....e@e@e.eee.....e@eeee@...
w.e.e@e.......e@..@ee.e....@e.@@e..w
..@e@...e@....@e..@e@.@e...e@.ee@...
......eeee.......ee..e@e@e@e.e@.....
w....e@@@.e...ee.@ee.@e...@e.@@e@e.w
..e@e@eee.@.e@@@e@@@e..@e.e..ee.....
....ee@@@.e@@eee@ee...ee............
w.ee@@eee.ee@e.......e@@e...e@e....w
..@e@e@@e.@e........e@.@e....e@e@e..
..e.e...e@e.e@.e.....@ee@..e.e..e@..
w.@.e..ee....ee@.....ee...e@.@.....w
..e.@ee@@eeee@e@e.e@e@@.@ee@ee@e.e..
....e@@e@.@@e.@e@e@...eee....e@e@@..
w.e.@ee.e.e@.e@e.....e@@@...eee.ee.w
..@e..e....e.e@e.....@@ee@e@@@e.....
....ee@.....e@e..e@e.ee@...ee@e.....
w..e@@@e.....e@e@e@e..e@e@e.e@e..e.w
..e@eee....e.e.@e.@e...e.e@.e@..e@..
..@e..@e...@.@e...e...e@e@..@e......
w..ee@ee@.ee.........e@.e..e..e@...w
..e@@e..e.@e....e@e....e@.e@...e@e..