33,36
367
367
1000
......@ee.e@e@@e..@e.e@e..@ee.......
w....@e.@e.e.eee@.e..e@e.@e@@e@e.e.w
....@e.......ee@eee..e@eee..e.e@e@..
...@e.e..e@ee@@..@@..e@@@e..@.@.....
w.@e.e@.e@e@e@e.@ee...ee....e@e....w
..e.....ee..@...ee@@e..e@e..e@ee@e..
....@e.e@@eee...ee.eee@@e..e@@ee@@..
w..ee..e@e@@@e.e@@..@@e.....@e..ee.w
...@e..@..eee@...ee.e.@...eee@@eee..
..e@ee@e..@.e@e..e@e..e...@@@eee@@..
w.@e....e.e.e@@..ee@....eeee.....e.w
..@e...e@....ee.e@@e@e.e@@@e.e......
..e@........ee.e@.e...e@@e@@e@.e....
w....e@e.e@e@@e.ee@@e.@ee.ee@@e@.e.w
..ee@e@ee.ee@..e@@ee.........ee@e@..
..@ee@@e@e@.ee@ee@e@...ee@eee.......
w...@.e@e.........e.@e.@..e@@e...e.w
..@ee.ee@e@....e..@ee..e..@e@e..e@..
..e@.e@@e@e@..e@e......e..ee@ee@e...
w..e@e.ee..e....@e..e.e@....@e@@e..w
...e@e@e@....e@e@..e@....e.@e..ee@..
....e.e@ee....e.e@.@@e...@.e..e@.e..
w.....@e@@e..e@@ee.ee....e@.e.@e.e.w
..e.e@e........eee........ee@@e@.@..
..@@ee@..e....e@@@.....e@....e..@e..
w.eee@e@.@ee....ee..e...e.......ee.w
.......e...@e...@ee@@e.@e....e..e@..
....@e..@eee@...e@eee@.e@...e@.e@e..
w.e@e.@eee@@...e@@e@.@e.e@e@e..e@..w
..e@e.e@.e@e@e...e@..e......e..ee...
..e@e....@ee@.e@...e...e@e.e@ee@@...
w..@e@....@ee.eeee@@....eee@@ee@ee.w
...e.e...e@e.e@.@eee...e@@e.e@..e@..