33,36
354
354
1000
....e@.e@ee@....e....e@e@e..........
w.e@.e.e.@.e@ee@@e...@e..@e...e....w
...e...@.e.@e..e.e.e@e..e.e@e@@ee@..
.......e@e...e@ee@.@e@.e@@ee.ee@.e..
w........@ee.@e@@e@.e@e@.ee@ee@eee.w
....@e.ee@@@e..e..e.......ee@@ee@@..
....ee@@@ee@@ee@@e@..e...e@@ee@e@e..
w..@e.ee...e.ee@e.e..@e.ee@ee@.@...w
...e@......ee@@e..@eee@.@e@.e@ee@e..
...@.e@e.ee@e@e..e@.@e@.e.e.@.......
w..e.e@.e@@e....e.e@e.e@ee@ee@ee@..w
..e..@e.....e..e@e..e@e....@e@eeee..
..@e......ee@.e@.@..e......@e@@@e@..
w.@ee@e.e@@e..e@ee@e@.....ee.ee@e@.w
..e.e@...e@.e@@ee@e.e.....@..e@@ee..
..@e.e....e..e@.@.@e@...eeee..@e....
w.@e..ee.....@eee..@ee@e@@e@..e....w
..e@..@@e...e@e@@eee@....e@..e@..e..
..e@e.e@e...ee@@ee@@e.......e@.@e@..
w.e@..e...e.@e.e..@e.........e.e@e.w
..ee..@e..@e.@....e.................
..@@e@e......ee.....e...@e.....e@e..
w.ee@@e.e...e@@e@e@e@...ee..e@..e@.w
.....e.e@...@eee@.e@...e.@e.@ee.....
...eee@e.....e..ee..@e.@ee@.ee@.ee..
w.e@@@e......@..e@..e.ee@...@e@e@@.w
..@.e@e.e..@ee.......e@..e.....e@e..
..e..ee@@e.e@...e@e.e@@e.@.....e....
w.....@e@@eee......e@@e@.e@e.@e@...w
........ee@@@e.......ee......e@.e@..
...ee.@e...e@ee.e.e@e@@.e....ee@ee..
w..@@@e...ee@e@e@e@ee@e.@ee.e@.e...w
...eee...e@e@ee@e......e@e@e@e.@e...