33,36
345
345
1000
...e@e@e..........@e....e@e.ee@.....
w..@e....e........eee..e@@ee@@eee@.w
.....e@.e@.ee...e@e@@e@@ee.e@e@@.e..
......e...e@@e......e.ee@e..e.@e....
w..e@ee@..e@e.ee@.....@@e@@ee.e....w
...@e@.e@e.e@.@ee.....e@e.ee@..@e...
...........e@e@ee..e...e@.@@.e.e@...
w...@ee@e...ee@e@..@ee.e@eee@@e@...w
..e@ee@.....e@.e@e@e@@e...@@ee@.....
..@@e@..e@e.e@e@.e@e@.ee..e.........
w.ee@..ee...e@e@.e@.e@@@e.e@...e@e.w
..e.@ee@@e.e@..e.@e..ee@e..e..e@.@..
..@ee@..e@......e@e.e@e....e.....e..
w.eee@e.@@e....e@@e@@.@..e@@@e...@.w
..@@e@..ee@.....@e@ee.e.e.eee....e..
..e@.ee@@ee@e@e.e.@ee@e@@ee.e@e.....
w..e.@ee..e@e.@.e.e....e@@@ee@e@e..w
.....e@..ee@..e@@.......eee.@e@.....
.........@.ee..ee.........@e........
w.e@e...eee@@e..e@.e@@e.e@e@..e@...w
........@...e@@e.e..ee@.@ee....e....
...e....e...e@e......@....@...e@e@..
w..@e....e@...e....e@eee..e@e...@e.w
.....e@.eee...@e.ee@.@@@ee@e.....e..
..e@e@e.@@e.@e@ee@@@eee@e..@e...e@..
w....e@@e.@eee@..@ee.@...e@.ee@.e@.w
..@e...e@.....e@ee.e@e....e.@@e.ee..
..e.......e....e@..@e@.e@e@ee.e.@e..
w.......ee@..e....e@e.e@.e.@.e@e@e.w
..ee@..e@..ee@@e....@e.e@@ee.ee@e@..
..@ee......@e@e.e..e@.e.e...e@@ee...
w..e..@e@e@ee..e@@e.e.@e@.e....e@e.w
..e@..ee@e.e@..e@e....e@..@e....e@..