33,36
350
350
1000
..@ee..e..eee@e@e....ee@e.e@e.e@e...
w.e@@e@@ee@@@ee@eeee.@e@...e..e@...w
......e@e.@ee@.e@@@@.e.e.@e@..@ee...
..e@.e@e@ee.@e@..eee....@e..e.e@@e..
w..ee.@e@@...ee..@@@e.@eee.e@.e@e..w
..e@@eeeee@e@@...ee...e@.@e..@ee@...
..@e..e@.@e.eee....e@e@..e@..e.@.e..
w.e@@e...e...@@e..e.e@@e.@e.e@@ee@.w
...@e..e@@...e.e..@e..e.......e.....
..eee...ee.@e.e@.e@e@...............
w.@e@.e....ee.@e.@e.e..............w
..@ee.@....e@@e@.e@@e.e@e......e....
..e...e.....@ee.e@.e@.......e.e@.e..
w.ee....e@e.e@@e.......eeee.@.e@e@.w
..@@e.ee@@e.....e....e@@@@@.ee...e..
..ee@.@e@e......@e.@e.eeeee..@e.e@..
w.....e.....@e@e@@ee@e..e@e..e@..e.w
........e@..e...e...e@e@@....e@e.@..
.....e@e@e@e........@@eee.e@ee@@ee..
w.e..e@@.ee@.......@ee.e@.e.@@ee@e.w
..@e@@ee.@e@......ee.e..@e@.e..ee@..
..e@e.e@.e@e..e...@..@@ee.e@@e@@e@..
w..@e.e@.@e.e@@...e..ee....eeeee.e.w
...e..@e.e@..eee@eee@e..e@ee@@e.....
...@e........@e..e@.....@e@@e....e..
w.e@@ee@....@e...e@....e....@...e@.w
...e@@.e....e...e@e.e@.@e...e...@e..
..e.ee....e@...e@e@.@e..e@..e@e..e..
w.@.@e.....e....e.@ee@e@@e..e@..e@.w
..e..@..e@@e@..e@@e.@eeee@e..ee@e@..
.....e.e@ee@e....e@.e@@.e@@ee@.e.e..
w.....e@e@...ee..@ee..e..e@e@..e.e.w
......e@e...e@@e..e@.e@..e@e..e@e@..