33,36
351
351
1000
.......@ee...@eee@..@e@.....e@e.e@..
w..e@..e@@e..e.@eee@e.e....e@@e@ee.w
...@e@e.....ee.e@@@e@@e......e@e....
..e@e.....e@@@e@.e.e.e.@e.ee@@.@....
w..e@e@e..@ee..e...@ee@e@e@.ee.e...w
..e@ee@@e.....e@...e@..e@e.....@e...
..@e@.e...e@..e@e..e@e...@e@e@.ee@..
w.e.......@e..e@e@.@.......e.e.@@e.w
..e@ee@e@e.@...@ee@e@e@e@e..@e.e....
..@e.e@e@..eee.e@..ee@e....ee..e@...
w.@e...@e...@@e@..e@@eee...@e..ee..w
..ee@ee@ee..ee.@e@.@e.@@@e.e@.e@.e..
..@@e.e@e@..e@.eee.e..eee@e@.e@@e@..
w.e@e.ee@@e.e@e@@...ee@e@e@.@e.e...w
....e@@@ee@...e@e...@e......e@e.....
.....ee@ee....e.@e.@e..ee..e@e@.....
w......ee@e...@e...e..e@@@e@..e....w
..e..ee@@e@.e.e@.e....e.ee....@e....
..@e.@e@ee.e@...e@.ee.@.e@ee..@e@...
w.@eee...@e.ee....e@@ee@ee@@e.e@e..w
..e@@e......@@.e@e@...e@.e@e..@.....
...e@e@.e...ee.........e......e..e..
w.....e@@e...e....e@e.e........ee@.w
..e@e.@e@e...@ee@e..e@@e.....ee@@e..
..@ee@e.e@..e@ee@e...ee@...ee@.e@e..
w.@ee@ee.@e....e@e........e@e@ee@e.w
..e...e@.e.....e....e.@e..@ee@@@.e..
....e@@.......e@..e.@ee.e@@e.eeee@..
w....eee@e.......e@e@ee@.ee......e.w
........e@@ee@e.....e@@e.e@...@e@@..
.....e@e@@e.e@e....e@e@@.@e...e.ee..
w.e.@e...e@.@e@...e@@eee....e....@.w
..@ee@.e@e..........e......e@e@e.e..