33,36
364
364
1000
..e.@e..e.......@e....@e............
w.@eee@.@e.@e@e.e@.e@ee.e@ee@......w
..@e..ee@eee@.e@e.......e@e@e@e@e@..
..e.e@e@@e@@ee.e@.....eee@e@....@e..
w....ee.e.e@e@..@e..e@@@@e@e...e...w
...@e@@e...e@.e.e.@eeeeeee@e...@e...
...e..@e..e@..@e..e@@e.@.e@eee...e..
w.....e..e@.e@e...e.@e.ee..e@@e.e@.w
..........e@.e@.e.@ee...@e.e@e..@...
.......ee@ee@e..@e@ee@.e@..ee@.eee..
w.@e..e@@e@eee....@e.e..e..@...@@@.w
..e.@ee@e.e@@@e..@e..@ee@e@e...eee..
..@ee...@e..ee...e...e@..@e@ee..e@..
w...@e@.e...@@e........e...e@@e.@e.w
...@e.e@@...e.@......ee@e..@e.......
...e.eeee@....e......@@........ee@..
w...e@@e@e.ee@e.ee@e.ee....e@e.@@e.w
......@ee@.@@e@e@e@@..e.....e@ee@...
......e..@ee.e@@@eee..@e....@.e.e...
w..@e@e..e.@e.eee....e@e..e@e@@e...w
...e@..e@.ee..@e...@e..@e....e@e....
...e@e@.e.@@e.....ee..e@e....e@@....
w....@e...e@.....e@.e.@e.e@ee.eee@.w
..e..e@....e...eee@.@ee@..e@@.e.ee..
..@e@@e@e...e.e@@.e.e@e@....ee@e@...
w.@eeee@e@e@@e.@e...e.@e@...e@@e...w
..e..e...@eee..ee..e@e@.ee..@ee@....
....e@.e@ee.@e.e@@ee@eee@@ee@@ee@e..
w.ee@@e@..@e@@@e.ee@ee.e@e@.e.@....w
..@@eee...e.eee.ee@..@eee..e..ee@e..
..e..@@.e@@.@.e@@ee.e@e@...@e...e...
w....ee.eee.e.ee.e@@e@....e@e@.e@e.w
.......e@@e..e@....e.e.....e.e..e@..