33,36
363
363
1000
..e@e.e@e.@ee@e..e@.....e.......e...
w.....e...e.e.@e@.e@e..e@e.ee...@e.w
...@ee@....e@...e...e@e@.@.@@e.e....
...e...e@e..@e@e.e@@e....e.e@ee@e@..
w...........e@..e.ee....e@e@@e@..e.w
..@e...........e@e.e@e..e@@eee......
..e...e@@ee...e@e..e@....e@e@@......
w.....@eee@e..@e@e@@e..e@.ee@ee....w
...e@e..e..@e.ee@eee@...e.@e.e@.....
..e@@e..@e@e@.@e.e.e@e@.....ee@e....
w.@ee.e@@e.e@e@@e@....ee....@@e@...w
..e@...eee.e@eee@e.e.e@@e...ee..e...
........@@@e.e@..@e@..e@eee@@ee.@e..
w...@e..eee...e..e@e@.e@e@ee@.@e@@.w
..e.e.e...e@.e@@ee..e..e..@.e@eeee..
..@e..@e@e@e.e@e.@e.@e...ee..e@@e@..
w.e@..e......e@@.e@....@e@e@e@eee@.w
.....e@.......ee.@e....e@.@e..@e@e..
...@e......e..@ee@e....e@ee.@e@e.e..
w..e.....e.@e.e@e@e.ee@@.e@eee@@e@.w
..ee..e..@......@e@.@eee.e@@.eeee@..
..@@..@..e..e@e@e.@e.@e..@eee@...e..
w.ee..e.e@e@.ee@@.e....e..e@@@e..e.w
....e@e....e...ee@....e@.e@eee@.e@..
..e..e@.e@e..e@@ee.ee.e@e@...@ee@...
w.@e@e@e.e@...e.@ee@@e@.....e@.e@e.w
..@eee@e.......ee.e@e.e@e...ee......
..ee@ee@......e@@e..@eee..ee@e......
w.e@@e@@e@..e@...e...e@@..@@e......w
....e..e.e...e..e@.e@@ee..e......e..
....@...e@.e@@..e@e.ee@@e@e......@..
w...e@@e...@ee..e@e.ee@e.ee@ee...e.w
.....eee@e...@e@e@ee@e@ee@e@e@..e@..