33,36
349
349
1000
..e@...e@ee@ee.ee@e@@e@ee...........
w..e.ee...e@e@.@ee.eee@e@e.........w
..e..@@e...@e@.....e...ee@.....ee...
..@e.e.@e..e@e.....@ee@@e.....e@@e..
w...eee@@.ee@e@ee@e...e.@e....e@...w
..e.@@.eee@eeee@@ee@e.@e.......e....
..@@ee..e@.e@@e@@e@e@e@e.e...e......
w.ee.@...e@@e.@eee@e.e@e@@e.e@...e.w
...e@e@e@@e.ee..@e@ee@.@ee@.@e...@..
...e@...eee@@@e....@.@e..@e...e..e..
w..@e...e@@ee@e....e@e@...@.e.@ee@.w
...e...e@@e@ee.e@..@....e.e@@ee@e@..
..e@...@ee.e@@..ee@e@e..@..e@....e..
w..........e@ee@@e.e..@eee..e..e@e.w
..e@.e@e.e.@e..e...@e@e..@e..e@@e...
...e.e@ee@..e......e..........ee@...
w.....e@e@ee@e@e@..@eee.....e@e.@e.w
....@ee@.ee@...@e..e@@@e@ee.e@e.e...
....e..ee@....e@@e...e..e@@..@ee....
w....e.@e...e@@e@.........e..ee@...w
....e@....e@eee.e@e@....e@@e..e@e...
.....@e@e...e@@e...e...@ee.@e..e@...
w..eee.@eee..e@@e..@e..e.@e....e@e.w
..e@@e.ee@@..@e@e.ee..e@....e..e@e..
..e@...e@@e......e@@e.e@...e@.e.....
w.@e...@ee..ee@e@e@@e.@e....@e@e...w
.....e@e.@.e@@..eeee.@e.@e@ee..@e...
.......e@e..@e@.e@e..e.eee@e@e@.e...
w...........e.e.@e@...e@@e@e..ee@..w
...e@.e@e@...e....e.....e.....e@@e..
...eeee@@e..e@.e.e@...e.........e@..
w..@e@@e..e.e@e@.@e..e@@e@e@ee.e@..w
..........@e@ee@e@ee@e@e...e@@e.....