33,36
365
365
1000
..@e....e@ee.ee...e@e..e@@e...@e@e..
w.e..e@e.e@@e@@e.....ee@ee....e....w
..ee@e@e.@e@ee@e@@e.e@@e.e@.ee..e@..
..@e@e@e...ee@@eee.@e@e@e@ee@@...e..
w....@e..ee@e@e....e..e@e@@..e.....w
.........@e@..e@e@e.e.e@.ee@..e.....
....e....e.e..@ee@.e@..ee..e..@.e...
w...@e@...e.@e.@ee.e@ee.@eee..e.@e.w
..ee@.e.ee@ee....@e.e@@e..@@...e@e..
..@ee...@@@eeee....e@e.@e.ee...@e...
w.@e@...eee@@@@......@e....e@e...e.w
..eee@e.e@@.eee......e.....e@....@..
..@@eee@e@e...@e@...e@...e@ee....e..
w.e..@eee@e..e@ee.e@ee@..e@........w
..e@e.@.ee@@e.e@...e@ee...e....ee...
..@e@.e.@e@e......e@e@@..e@@e@.@@e..
w.e....ee@.@e.@e......e@ee@e.e.ee..w
..@e..e@....e.e.......e@e.e.....@e..
.........@e.@.@@ee..e@ee@.@e@..e....
w.e@ee@e.ee.e.ee.@ee@e...ee@ee@@e..w
....e....e@e@..eee.ee@...@ee@.e.@e..
..e.@e..e@@e@ee@@@.@..e@.@ee@.e.e...
w.@e@.e..@ee@ee@ee.e...e@e.@e.@e@..w
..e@e.@e.e.e@e@e.@e@e@..e@..@ee@....
....e..e....@ee@.ee..e@..e..@eee@...
w..e@..@...ee.....@e..e..@e.ee@@e..w
....@e.e...@e@e.ee@ee@....@e@...@...
....e......ee@ee@e@..e@@e..ee@e@e...
w.ee@.eee..@.@e..@e.e.ee.e@@e@.....w
..@eee@@@eee.e...@e.@e@@.@e@.e..e@..
...e@@ee@e@..@ee@e@e@eee...e.@.e.e..
w...@e.e@e@e.......@..@...e..ee@...w
....e@..ee@e.......e..e...@e........