33,36
369
369
1000
..e.....ee.@e.e@eee@e...@e@e........
w.@....e@@.e..ee@@e@e...e..e..ee...w
..e..e...ee@.e@.ee.e@......@.e@@....
..e..@@ee@.e.@..@@ee@e@e...e.e.ee...
w.@e.ee....@@ee.ee....e@..e..@e@@e.w
..@e......eee.@e@@e@.e@.e@@e.e.ee...
..e.....@e@...ee@e@e@e.eee.e@ee@@e..
w.@e....e......e@e@e@e.@@..@ee@@e..w
..e@....@e....e...e.eeeee@e...ee....
..e@@e..e@@e@.@ee@e.@@@e@e.@e.@@e...
w..ee@....e.e..e@e@.ee...@.ee.e....w
......e.ee@.e.e..e@e.@e..ee@@e..e@..
...e..@.@.@e@e@e@ee@e@e....e@....e..
w.e@.eeee.eee@@e@@ee@e@.@e@.e@e....w
..e@e@e@...@e.e.e@e@e.e@e.e.e@e@e...
...ee@e@...@e....@e.@e@...e@ee@e@...
w.....@e..@e.....e..ee@e@.e@@e.....w
...e@e@e..e@..e@e......@e.@e@e.e.e..
...@e....e@..e@e@...........@ee@e@..
w...e@..ee.....e@......@e.e.e.e@@e.w
.....ee@@@e..e..e@e..e@e.e@..e.e....
....e@.ee@e.e@e...@..e@@.@ee@@..@e..
w.e@@e..@e..@.@e..e..@ee...eee..e..w
...eee.e@e.ee@e@..e.e.....e@...e....
..ee@@.e@e.@ee...e@e@e..@eee.e@@e...
w.@@ee.e@e...@ee....e@eeee@@..e....w
..e....@e..ee@e@...e@@e@ee@e.....e..
..e.e@e.e..@ee@.@ee@ee@.@e.e@ee.e@..
w.@..e@.@e......e..e@e.e@e.e@e@..e.w
..e.......e@e@ee..@e.@e@ee.e@e...@..
.........e@@ee@@@ee.e@ee@@ee.e@e.e..
w.e......@ee@@eee.@ee@e.ee@@e......w
..@e........e@ee@e@e...e@e@e........