33,36
358
358
1000
..@ee@e@e.e.e..e@e@e.@e.e@....e.....
w.e......e@e@...e.e@.e...e.eee@....w
....ee...e@e....e@.....e@ee@@e.e....
..@e@@e...@ee@...e.e...@@ee@e.e@e@..
w.ee@..e@.ee.ee@e@e@e@@ee.e@.ee@@e.w
..@@e...e.@@e@.......ee...eee@.ee...
..e..e@e..e..@ee....ee@..e@@e..e.e..
w.e@ee.@e...ee@@e@ee@@e.e@@e...@e@.w
..@e.@e@e...@e...@e..e@...e....e....
....e@@e....e@.e@e@..e@e.....e.@e@..
w....e......@e.@@eee@ee@ee@.e@...e.w
..e@e@e@@e...@eeee@@e...@.eee@e@e...
..@e..@ee.e@e.e......e@@e.e@.e@@e...
w.......ee@...@......eee.e.....e.e.w
..e.e@ee@.ee..e..e@..@e.e@.......@..
..@e@.e@@e@@e@e..@eee@e.....e@e..e..
w.ee@e.@e@e....ee@e@e.@e@ee.e@..@e.w
....e@.ee@@e@..@.ee@@@ee@e@e@e..ee..
....@e@@ee.@e.@e@e.eee.e@ee@.....@..
w.e.eeee@@e...e.e@.....@e@@....@ee.w
..@e@@@e@e@..e@@e.....ee..ee...e....
..e.@ee@e.e..@ee......@@e.e@.e@.e...
w...e.@.e@@e.@e.......e...e@@ee.@..w
..@e@ee@eee@.e.e@..ee.e@...eeee.ee..
..e.e@@.@e.e...@e.e@@e@e....e@@.@@..
w.@e@.e....@e...e@ee@e.@ee....e.ee.w
..ee@.....e@....@e@.@e...@.e@e@@e...
..@ee@@e...e...e..@ee...@eee@@eee...
w.@e.ee.......e@@ee.e@e.e.@eee@@@..w
..e.@ee....e@..ee.e@@......@...ee...
....e.@ee..@ee.@e.@ee.@e...e@e.@....
w......e@..e@@........e....e@@.e...w
.......@e....e........@e....ee@e....