33,36
353
353
1000
....e@e..........ee@@e..e@.@e...e...
w.......e...@e...@eee@..@e.e@@ee@..w
........@...ee@e.e@e@.e@e...ee......
.......eee..e..e.@..e.e@ee..@e......
w......@e@.e@..@eee@@..e@@ee@@.....w
..@ee@ee@e.e@ee@e.@ee.e@..@eee......
..e@e...e@@e..e@..........e@e@..e...
w.e.@e@e@@e...@e....e.@e@e.e....@..w
..@eee.e@e...ee.@e.e@.e...e@e..ee...
..@ee@...@e..@@eee...e@.e..e@@e@e@..
w.e.e@e...@e.e.e@@e@e..e@....e@.@e.w
..@ee@e@e@e@..e@.@e@.....e@eee@@e...
...@e@ee@.e..e@e@e@e.....ee@@@ee....
w........e@ee..e@ee@..e@e@..e......w
........e@..@e.e@e.e@e.e..@e@.......
......e.e@e@e..e@..@e@@e..e.........
w...ee@.@e@...e@ee.ee.e@@ee..e@....w
..ee@.ee@e...e@ee@.@@e..ee@e@ee@e...
..@@ee@@e@...e@@@e.e.....e@e@..e@...
w.e.eee@e.....ee@e.@e....@e.e.@e...w
..@e@@@@e...e@e.....@e@..e@.@.e@@e..
..e@eeeee..ee@e@..ee.@e..e@ee.e@e...
w...@e@@@e@@e@@e..@@..........e@e..w
..@ee@.ee@e..e....ee.........e@e@...
..eee@e...@e@e....@.......ee.e@.e...
w.e@.@e..e..e.ee@ee.e@....@@e.e@@e.w
....@e...@..@.@@e.@.ee..e.e@e..ee@..
....e..e@e..e.eeeeee@e.e@.e@e...e...
w..e.e@e.e.e@.e@@@@@e.@e.e@@e@e.@e.w
...@e..e.@e....eeeee@.e..e@e.ee.e@..
...e@.e@...e@e.@@e@e..ee.e.ee@@ee@..
w....e...@e..e.e@ee@..@@.@e@.....e.w
....e@e@ee...@e....e@eee.e..........