33,36
365
365
1000
..@ee@..e..e@...e....e@....@e@e.....
w.e@.e..@e@eee..@.ee.@e..e@ee@e.@e.w
...e@...e@e@.@e.ee@@e@e@e.ee..e@e@..
...@e..e@e...@e.@.e@@e@..e@@.e@e.e..
w..@e..e@@e@ee.ee..e@e.e.e@e..e@.@.w
..ee....e.e.@e.@@e@eee@@.....e@@ee..
..@.......@e@e.ee.e@@eee@e...@.e@...
w.e...@e..e.e@.@@ee@@e..e...ee.....w
......eee......e@..ee...@e.e@e@e....
..ee..e@@e......e@e....e@ee@@e......
w.@@...e@....e...e@e...@e...e....e.w
..ee....e....@ee...@e@@e.e@.....e@..
.....e.....ee@e@..e@@ee...eee@e@e@..
w.@e.@e..e@@..e..e@e...@e..@ee.e.e.w
..e..e@@e@ee.e@..e@@e..e...e@.......
...e@@ee.e..e.....e@...e@e.@e...e...
w.eee@e..@e@@@ee@e.eee.@...ee@.e@e.w
..@@...e.e.eee@e@e..@@ee...@ee.@e@..
..eeeee@.e@e...e@@e.e...ee.@e.ee....
w...@@e@.......@e.e.e..e@@eee.@....w
..e@e@eeee........@e@e..e@ee@.e..e..
..@e..e@@@ee.@e...e@e@......e...e@..
w.....e@e@@@eee@e@...@ee.e@e@e..e@.w
..e...@e.ee@e..e.e@e.ee@@e@e@@@e.e..
..@.e@e@......e..e@e...@e@..eee@e...
w.e.@e....@e..@e.e@e...e....e.ee@e.w
...e@e.ee.e@e@e@............@e@@.@..
...@e@.@@e.....e.e@e..e@ee.@ee@e.e..
w.e@.e.e.@.....@e.e@.e.e@@ee.@e.e@.w
...ee@.@eee@e@....@e.@..e@@ee@e.@e..
....e@e.e@..@e.......ee..e@.........
w.e@e.eee@...@e@e....e@...ee.e@e...w
..e@ee@@ee@ee@e.@e...e@e@ee@.e@e....