33,36
358
358
1000
....e@e...e.e@@e.e@@e...ee...e@e@...
w.@e@e@...@eeee...ee...e@@e..e@.e..w
..ee@ee.e.e@@e.e......e...e..ee.....
...@ee@.@e@e@@e@e.e...@e..@ee@@ee...
w.e@e@ee@@..e...@e@..e@e.ee@.e@@@..w
...e..@eeee...e@@e@..e@ee@.ee.eee@..
..e@..e...@e...ee.ee.e@@@ee@@e@@ee..
w.@@e.@ee.@e@....e.@e@ee@ee@e.eee..w
..ee...e@@eeee@.e@.....e@..@ee@@@e..
..@....@ee@@@ee.@e...e@.e..e..eee@..
w.e........e.e@.....@eee@e@.@e@e@e.w
.......@e@..e...e...e..@..e.e@.e....
...@e..e.e..@e..@e..@..e..e@e.e@....
w..e......e@eee..@e.e.e@eee@@..e@e.w
...@e...e@e@e@@ee@e.e..e@@eee.e@e...
..ee@.e@e...e@@e@e@.@e@ee.e..e@.....
w.@@e...@e...ee...@e.e@@@.@e..@ee..w
..e.@e...e...@e...e@.@eeee@@.ee.@e..
....e@@e.@ee..e....e@.@e.@eee@.e.e..
w.@e..e..e@@e.@....@e@e.e.e@@.e@e@.w
..ee@.e....e@@e....e..ee@.@ee..e....
...@e.@.e.e@ee.e.e@e.e@@e......@e@..
w....eee@..e@..@..e@..e@e.....@e.e.w
.....@@e.e@@e..e..@e@..e@e....ee@e..
...e@e.e..e@ee@ee@e.e@e@e@.....e@e..
w..e@e@@e@e.@e..e@..e@.....e@e.e@e.w
....e@ee....e@...e..@e...e@....e@e..
..e.e@.@e.e.@e....e@e.....ee@e..@e..
w.@..e@ee@@e@.....e@.e...e@..@e.e..w
..e@e....e@.e@.....ee@...@e.e@e.@...
..........e..e....e@e@...e@..@e.e...
w.........e@e@e...e@@e@.e@..ee@e.e.w
..............@e...e..e....e@.e@e@..