33,36
356
356
1000
....e@e.e@e.e@e@ee@e...ee@e.e.......
w.e.e@@ee@e....@e@..e.e@.@ee@e@ee@.w
..@e.ee@...@e..e...e@....e.e@@e@.e..
..ee......@e..e....e@..e.@.eee......
w.@@e.....e..e@....@e.e@.e.@@e.....w
..ee@e..e..e@e@e.....ee@e@ee....ee..
.....@ee@ee......e..e@@e.e@@ee..@@..
w.e....@..@..e.e@@e.e@@ee@e@@@e.ee.w
..@e.e.e..ee@@e.e@@e@eee.@eee@@ee@..
..e@e@e@....e@e.@e..e@.@.e@.@ee.e@..
w....@e.......@e...e@..e....@e@@ee.w
.....e.e@.....@e..e@e..e...ee..e....
...e@e..e.....ee..e@@e@@e.e@e@e@e...
w..e@e@e@e.e@ee@@e.ee.e@e.e@e..e@..w
...@e@.ee@...ee.e@......e.e@@..@ee..
..e@e..@...e@@@.@e@e..@e@eeee..e@@..
w..e...e....eee.e.e.eee..@@@@e.e@e.w
...@...@e.....e.@.@.@@@e.eee..ee@e..
..ee...@e..e.e@@e.e.ee.@e..e@e@@e...
w.@e...ee..@...e@....@e...e@e.@e@..w
..ee....@eeeee.e@ee@.e.e..@...ee....
..@@@e..e@@@@@e.e@.e@@.@e.ee...@....
w.eee...@.eeee......ee@....@@e.e...w
....@e@.e@.e@@eee.....e.e@eee@......
.....@e.@e.@e.e@@e.e...e@@ee@.......
w.e........e@e@.e@e@e.e@.e@e..e@e..w
..@e.....e@e.@e@e@e@@e..@e.@e.......
...........e@ee@...e@e..e...........
w.e@e..@ee@e...e.e..........e@..e..w
..e@e@ee@ee@@ee@e@..e@e.....ee.e@...
..@e@e@e@@e.e@..e@.e@.e@e...@.e@@e..
w.@ee..ee.ee@...@ee@..e@@e..e.e@e..w
..e.@e.@ee@e@e....@e...ee@..........