33,36
369
369
1000
...@e@..e@e.@e....ee...e...e@eeee@..
w..e.ee.@e@.e.e..e@@@ee@e.@e.e@@@e.w
...e@e@.......@e.@.eee@ee.e..@@e.e..
..e...@e@e.e@e.e@e.@e.e@@e@..ee.e@..
w.@e..e........@eee@ee..ee@e....e@.w
.....e@e.....@e@.@@e.@e@.e@e@ee@@e..
..e.e@e@e...ee@e.e.@ee.e@ee.e@.e....
w.@e..e@e@e.@e@e..e@............e..w
..@e@ee@e...@e..e@@e.ee......e@.@...
..e...ee.e@ee.@e.e@ee@@e.....ee.e...
w.....@@e.e.e@e.e@..e@ee...ee@@..e.w
......e@.e@.@e...e@e@e@@@ee@.@e@e@..
..e....e.e@e...@e......ee..@ee.e@e..
w.@ee@.@e@eee.ee..e@e.e@...e.@.@ee.w
.....e.@ee@@@e@@e..e@@e...e..e.@e@..
...e@e.ee@.e.@.e@e@@.ee..e@@ee.e....
w.e@@e.@..e@.e...eee..@.e@eee@.....w
....e..e.....e..e@@.@ee.@.@e@@e.e...
..@e@@e..e@e.@e.e@e.e.@.e....e@.@...
w.e..e...@.e..eee@@.@ee...e@ee@ee@.w
..e......ee@ee@@@eee@e@.e..e.@...e..
..@ee@.e.eee@@.ee...ee.e@e.@ee@.....
w..eee.@e@@e.e..@..e@@ee@@e@e.e....w
..e@@ee@e@e..@e@e...e@@@eee..e......
.....eee@...........eee..@@e.@e.e...
w.@e.@@@e....e@e....@e@..e.e...e@..w
..e..ee.....e@e....eeeee.e@@........
...@e.eeee...e@e@ee@@@@@e.ee....e...
w..e.e@@@@..e@e....eeee....@e.e@@e.w
...@...eee..e@@...e@.......e@.@e....
..ee..e.....eeee@.@e...ee...........
w.@e..@...@e@@e@e...eee@@e.e@e.e...w
...@e.e.e@e.e@e....e@@e..@e@..e@....