33,36
359
359
1000
........e@e.....e@e....e...e.e@@ee..
w.....eee@e.e..e@e...ee@.e@@.@eee@.w
....@e@@e@e.@..e@@ee@@....ee..e.e@..
....ee@e..@ee...e...ee.@e.....@@ee..
w....e@ee@@e@e.@e..e@e@e@.....ee.@.w
..e@e@...ee..@ee...e@@e..e@ee....e..
....e@......e@@e...@e@eee@.@@...e...
w..e.e.e...e.e@e@@e.ee@@@..ee...@e.w
..e@...@ee@@e.e@ee..@e@ee....e.e@...
..e@e.@e@@e..e@.......e...e@e@.@e...
w...@.e......e@e@...e@@@e.ee@@e@@..w
....e.e..e.e@e..e...@eee@.@eee.eee..
......@e.@e......e.....e@e@e@e...@..
w....e@.....@e@.e@.@e.....e@e@e@ee.w
...e@ee.e...e.e..e@e@.....@e..@e....
........@e.@ee..@e.e.....e@.........
w.e@ee..e@.e@@e.e..@.e.e@@ee@.e....w
..@e@@..e@e@e@e.@e.e.@e.e@e.ee@.....
..@e@e...@e.e@@..............eee@e..
w.e......e...ee@e..e@@e....e@@@e@@.w
...e........eeee.e@eee...e..eee.ee..
...@e..e.e@e@@@@..@ee..e.@e..e@.....
w...e@e@.e@@@eee.eee@ee@..e@ee@..e.w
...e@e@@e.eee@..e@...@@..e@@e.eee@..
...@...e..e@e@.......ee..e.ee.e@e@..
w.ee@e....e@.e.....ee..e@@..@e@e.e.w
..@eee....@ee@e@e.e@@eeeee....e@....
..ee@@e....e@e@e.e..e@@@ee..........
w.@@e....e.e@e@@.@ee@ee..@.e.e@e...w
..e@e@e@e@.@e.ee.e@@ee@..ee@e@@e@e..
...@e....@e@e.@e.e@e@e@ee@.@e@e.....
w..e.....eee@e@@@e@ee.e.@e.e..ee...w
.........e@..@eee..e@e@.e@e@.e@@e...