33,36
352
352
1000
...@e......e@e@@e..e..ee@...e@ee@e..
w..e...@ee..e.ee@..@e.@ee...@e.@e..w
..e@...e@@ee@@e@...@ee@@.....@.e@...
..@e.....e.e@e.@ee.e@.ee.....e@e@e..
w.e.@e..e@@ee.ee@@....ee@ee@ee@....w
..@ee.e...ee@.@e.e....@e......ee....
..@e.e@@e..e........e@....eeee@@@e..
w.e@.e@e...@e.e@.e...ee..e@@@e@ee..w
.....@e....e@.@e@@..e.@e...e........
......e@.e.@ee@eee.e@e@e@e@@e.......
w..@e..e.@e@ee@@@@.e@e@ee.e@e@e....w
...e...@.e.@eeeeeee..e@e..@@e@@e....
.......ee@.e@@e..e@..ee@..ee.e......
w.e.@e..e@e.e@@e.ee..@e@...e..ee@e.w
..@ee..e.e@..ee@e@@e@@eee@e@.e@e@e..
..e@@ee@ee.e@e@e@e@eee...e@....e@e..
w....e@.e@....@e@..e@...e..........w
..e@.e@e.@e..@e.e......e@.e@e.e@e...
...e.e@..e...e....e@e..e...e@..e@e..
w....@e.e........ee@e.e@.eeee..@...w
........@.......e@....@e.@@@@e@e....
...e....ee..@e..e@e....@.eee@.e@@e..
w.e@e@e@@@e.e@@e..@e..@e....e.@ee..w
..e@@e.ee..e@@e@.e@e..e.......e@e@..
...e@@.e..e@ee.....@e....e@e@.e@ee..
w...eee@e@@....ee@ee@....@..e.@e@e.w
...@ee@e@ee...e@.e@@@e@e.e....eee@..
..@e@....e.....@e.@ee..@e@....e@e@..
w.e..@e..@.e@.ee@.e....ee@ee@e...e.w
..@..e...e..ee@@..@ee@e.e@ee@@e@.e..
..ee...@e@.....ee.@e@e@.e@e@e@eee@..
w..@e.ee.......e@@e@.e@.@e..e......w
...e@e@..........e....e..@ee@..e@e..