33,36
364
364
1000
...e.......e@e..e@ee.@e@e.e@ee..e...
w..@ee@e@e.@e@.ee@e@.e.....e@@ee@..w
...e....e@..e@e@.ee@e@......@e.e@e..
..e@.ee@e.e.@e.e@e.ee@e.e@e.e@.@e...
w.@ee@@@e@@e.@e@e.e@.@e.@e@....e@e.w
......ee.e@e...e@....e.e......e@e@..
.....e@e@..e..e@e@ee...@...ee..@e@..
w.......e..@e...eee@.e.e...@@e@e.e.w
..e@e.....e....e@@e.e@.....e....e@..
..@.@.e...@@e...e.....e@e.......e@..
w.e.e.@e.eee@..e@@e..e.e..e@..e.ee.w
........e@..e..e.e..e@.@e.@e.e@e@e..
...e@e..e@e.@..@.e.........@e..@....
w....@..e@e.e..e.@e.....e@e....e.e.w
.....e...e@e@.....e@@e...@e..e..e@..
.......e...@.e.@e@eee@...ee@.@e.....
w..e...@e.ee.@eee@e.ee@@e..e@e.....w
..e@e@....@e.e@e@@e@@@ee@......ee...
..@e.e@e@e@e..ee.e.ee.....ee...@@e..
w.e...e@...@ee@@e@...e.e@e@@e..e...w
..@...@...ee@.e@e..ee@ee@ee@e.ee@e..
..e...e.e.@@e..@e..@..@@@eee@.@.e@..
w..@e.e@@ee@ee.e.e@e..eeee@@e.ee...w
...e@.@e@ee.e@e......e@..e@e..@@@e..
....e@.ee.@e@@e.e...ee@e.e....eeee..
w...@e.@@.e@.ee@@@ee@e@e.@.e....e@.w
..eee..ee@.@e.@eee@@ee@e@ee@@e.e@e..
..@@@ee@.e.e@...e@.e@.......e..@@e..
w.eee@...@e...e@e@e......@ee@..ee..w
...e@....e@....e@..@ee.e.e.e@e..@e..
..e@@ee@.@e..e@eee.ee@e@.e@@e.@e....
w..eee.ee@e..@e.@@ee@e.e@@e@e.e.e@.w
..e@e@....e@e@e.e@e.e@..e..e@....e..