33,36
350
350
1000
..e@e....@e.e.....e@e.ee@@e@.@e.....
w.e@e....e@.@.ee.@e...@eeeee.e.@ee.w
...@e..e..@eee@@ee....e@.e@e...e@@..
...e@.e@..e.@..e@.e@ee@...e@...e@e..
w..@e@e@e@..e.@e@.@e.....@e.e@.....w
...ee@e..e@e..e.e..e...e@e..@e..e...
..@e..@.@e.@......e@.ee@.e@..@ee@e..
w.e..ee.e..ee@....e@.@e@e.e...e@@e.w
.....@.......ee@...e.e@@e.......e@..
..e..e......e..ee@e..e.e.....ee@e...
w.@@e@..e..e@.e@....e@...e@e@@ee@..w
..eeee..@e......e.....@e...@ee@@e...
....@e.e@ee@...e@e.e@.e@.....@e@e...
w..e@eee@eee@.e@@e..e.......eee@e..w
..e@e@@e@.@ee.@eee..ee......@e..@...
..@ee@@ee...@..e@@e@@@eee...@e@ee...
w....ee.@...e...e..ee@e@@e..ee@@...w
...e@...e.ee@...@....e@@e.....eee@..
..e@e.....@...e.e......e@....@e..e..
w.@e@e....e@e.@.@ee@e@e@.eee@e..e@.w
...e@@e.eee@e.ee.@......e@@@e..ee@..
....e.@e@@....@@ee.e@e....e@e..@@e..
w....e@e@ee@..ee@@e@@e@......@ee@e.w
...........e.e@@e@e.e@e....@ee...e..
....e..e@e....ee.@e.e.@.ee.e@....@..
w...@e...@e.e.@e.e.e@@ee@@e@e....e.w
....@e.e..@.@e@e.@...e@..e@e@..e....
....e..@.ee@ee@e@e..e@...e@ee@e@@e..
w..e...ee@.e@.e@..e@ee...e@e@.e@e..w
...@...@e@e.eee@.@e..@e.e@@e@eee....
...e...e@e.e@@@e.e.....e@@e.e@@@....
w.e..e..e@...e@@ee.eee@e.e.@e.ee@e.w
..@e.@e.@e....e.e@e@@e@e.e@e.e@.....