33,36
358
358
1000
..e......e@..e@@e.e@@e..............
w.@......@ee@.ee...eeee@.ee..e@@e..w
..e...@e....e..e@e..@@.ee@@.e.ee....
...ee@e.........e@..ee.@e@e.@e@@....
w.e@e@@.......e@@e...@.@e.e.ee.e@..w
..@..ee.....e@eee@...e.e..@e@@eee@..
..e@e......e@@e@..e..e@..@e@.e@@@e..
w.ee@........ee@.e@...ee.e.....ee..w
..@e@.e@..ee..@ee@@e.e.@....e@e.....
...ee.@ee@@@ee..e@ee.@eee@e.@ee.....
w.e@@ee@eee@e@..@e.@eee.@.@e.@@e.e.w
.....e@@e@@e@ee...e@e@@.eee@.e@e.@..
.....@ee@.eee@@e...e..ee.@e.e@@e.e..
w...e@ee.ee@.....ee@...@e.@.eee....w
...e@.@@e@.e.ee@e@...@e.e@ee@@......
...@e@ee...@.@e@ee@e.e....@e@e..ee..
w..@e...e@.e...e@.@e...e@e.e@eee@@.w
...e.....e..e..e@ee.....@e.ee@@e@e..
...ee@e.....@e.@@e@...e.e.e@@e@..e..
w..@e@...e@e.e.ee..e@e@e@..@e.e..@.w
..e.ee..e....@...e@ee@@e.e@e..@..e..
..@e@...@....e..@e..@.e.e.e@..e@e@..
w...e@e.ee......e.e@e..e@@e...e.e@.w
.....@e..@.e@e@e@.e......e....@e.e..
..e.@e...e.ee.e.@e@e@e@@e.......ee..
w.@ee..e...@ee..e@e@e@ee..ee....@@.w
..@e@.e@..ee@@e.@@e.e....e@@.@e@ee..
..e@.e@..e@e@ee.ee.e@e@e.e.e.e@ee...
w....e@ee.e@.e@.....e@...@@e...e@e.w
.....e@e@.........e.@e.e@ee....e@@..
...e@ee@@e@e.e@.@e@.e@ee@e@e....ee..
w.e.....e...e.e@ee@ee@@ee.e@...ee..w
..@e.......e@...@e...ee@@e....e@@e..