33,36
365
365
1000
...e@@e..e@ee@e.e@e.e@e.e.e@.ee..e..
w..eee.ee@ee@.....e@e..e@e.e.@@e.@.w
..e@.@e@@.@e..@e@ee@e..@....@e@e.e..
..e@eee@e..@eeee@......e...@e.......
w.@e@.e@.....@e.e........e.ee@e..e.w
..e....e..eee@e...ee.e@ee@..@ee.e@..
..eee@...e@@e@e..e@@.e@@e@@ee@@e....
w.@@@e..e@.e.e@e@e.e..e..ee@e@e....w
..ee@e.e....@ee@e...e.@....e.@e.....
....e@.@@e..e.e.@e..@ee.@e.@ee@..e..
w.@e@e@ee@e@ee@......@e.e@.e@..ee@.w
..e....e......@ee....e@@e...e@e@.e..
....@ee@e@....e@@ee..@ee.e@.e@e.e@..
w.e.e@..@e.e.....@@e..@e..e.@e..@e.w
..@e....e..@.e...e..e.......e@......
..e..@e.@..e@@e...e@@e@.e...eee@e...
w.@@eee@e...ee@@e.@ee.e.@e..@e@@ee.w
..ee....e@e@e@.e@e..e..e@@e.ee.e.@..
.....e.....e...@.@..@...e.ee@@e..e..
w...e@ee@.e@.e.e@e..e@..e@@e@e...@.w
.....e@@e....@ee@....e@..e@e@ee..e..
...e@e@e@.e@@ee.e..e@.e@e.ee@e@..e..
w...e.e...@eee@....@e..e..@..@@e.@.w
........e@..e@e@e@e....@e.e..ee..e..
...e....@eee@ee.......e@e....@..e@..
w..@ee@ee@@@e@@e..e..e....e@.eee.e.w
...@e@....e.....e.@..@e....e@e@@e@..
...e.e@e.eeee@e.@ee.....e.e@..e@ee..
w..@e@..e@@@e.....@e..e.@e...e@e@@.w
..e@e..e@.e@ee.......e@e@e..e.@e.e..
...e@.e@..@..@e@.........e.e@.e..e..
w.e@@ee@eee..eeee@@e.ee.e@e@...e.@.w
..e@e.e@e@..e@@e.ee.e@@ee@e@e..@ee..