33,36
354
354
1000
...e@.e@e........e........e@ee@.....
w...e....@e...e@e@e........e@.e.@e.w
.....e@e@e..e..ee@@...e@e.e@@e..e@..
........@e.e@....ee....e@...ee.@ee..
w.......e..@e...e@@ee..@ee@ee@.ee@.w
....e@.@e..e@.e@ee.e@e@@e..e@e..e@..
.....e.eee.....e.@e@@eee.e@@e....e..
w.e@e.e@@@ee@e.@ee@.e.....e@..ee.e.w
..@e@.@ee@e.e.e@.@e........e.e@@e@..
...e@e...e@e@..e......e....ee.e@e...
w.e@@ee..@e.ee@e..e...@@e@e@@e@e@e.w
..e@e.@e@e.e@e@e..@ee.ee.e@@e@..e@..
....@.e@ee.ee@e...e@@....@ee........
w...e..e@@e@@e@...@@ee@e.e@..e@e...w
..e....e.ee.@eee.@eee....@...e.@ee..
..@e...@e.@ee@@@ee@.@e@e.e.e.@e..@..
w..@...e@e....e.......e@...@e.@e@e.w
...e...@e@..e@.....ee@e.....e....e..
....eee@.....e.....@.e@@e...@.e.e@..
w...@@@e...@e@..e..e.e@e..e.e@@e...w
....ee@@e@ee..e@@e@@..@e.e@@ee..e@..
...@e.e@e......e@eee.ee....e..@e@e..
w..e.e@........@@ee@e@e@e.....e....w
...e@e@.e...e..ee...e@e..e@e@e.e@...
....e@ee@...@e.@e......e.@ee@e.@ee..
w..@ee..@eee@e.....e...@@eee@eeee@.w
...e.@e.e.@@ee@e@e.@e@eee@@.e@@@@...
....e@@e..ee@@ee@e..e@@e.eee..eee@..
w.e..e@e@ee@e..@e@...e..e@e@..ee.e.w
..@..e..@e@.@@e.e@e@...ee@@e.e@@....
..e.e@..e...ee..@e.e@e@@ee@e.e@e@...
w.e@@e@e@.......e.@ee@e.....e@..e..w
...ee..@e......e@.e...e@e....e@e@...