33,36
358
358
1000
..e....eee@ee@e..@e@ee..e@ee@@eee...
w.@e...@@e@e.....e.e@@e.@ee.ee@@@..w
..@e..ee@e@e........ee.e@.@e@@@ee...
..e..e@@e.@e.......e@@e.eee.@ee.....
w.e@.....@e.....e.......e@e.e......w
..@ee@.@eee@e...@e........@e.e@e....
..e@.e@ee@.e@@e.e@...@e...e..e@e.e..
w........e...e..e@e@@eee.e@...e@e@.w
...e@ee@e@.e@e...@eee@@@.e..........
..@e@e@e@..@@ee..ee@e.eee@@e.e@..e..
w.e@....@e.eee@..@e@@....@e...e.e@.w
...@e...ee..e.@ee..ee.e@.e..e..e....
...ee...@@e.@ee@@e....@e...e@.e@....
w..@@e.ee@.....e@@eeee@e@..@e......w
...ee..@ee......e..@@e..e.e@e.e@e@..
...e@.....e.e@.....e.e@e..e@e...@e..
w........e@.ee....ee.....e..ee@e@..w
...@e.......@@e..e@@e@e..@e@@e@@e...
...e@e....eee@e..@e..e@@e@eee.e..e..
w..e@@e..e@@ee@.ee@..e@eeee@....e@.w
...@e@@e...@e.ee@@e.....@@e.....e@..
..e..e.@ee@eee@@.@ee@@e.e......@ee..
w.@e@ee@e@..@@.e.e.@ee@.......ee.@.w
..e.e@@e....ee...e...@e....e@e@@ee..
..@e...@...@e....@e...@..@e...@e....
w.e...ee...e@..e..@.e.e..e..e@e....w
..@e@e@@e@e..ee@.eee@..@e....ee.....
...eee@@e..ee@e..@ee@@eeee...@@@e...
w..@e@eee@e@@....@e@ee@@@@...eee@e.w
..e@e.e.@@e.e@..ee.....eeee@eee.e@..
...eee@.ee.e.e.e@...e@e@....@@@.....
w.e@@e@.e@.@...@e...ee@@e..eeee@e..w
....e.e.@e.ee@e@e..e@e@e..e@@e......