33,36
351
351
1000
........e......e@@ee.e@e..@e.e@e....
w......e@.......ee.@e@....e...e@...w
....e@.@eeee....@@.ee@e...@..ee.....
...e.e...@@@e..eee@ee@e@..e@e@@.....
w..@e@e@eee....@@@eee@ee..@ee.e.ee.w
.....e.e@@e....ee.e@.....e@e@..e@@..
..e@e..@..@.@e@ee.@e..e@e..e@e.@.e..
w.e@@e@e..e.ee@e@.ee@e..e......ee..w
..@ee@....ee@.e@@e@e@@ee@e......@e..
....@.e@ee@@..@ee.e@e.e@@e@e...e@e..
w...eee@e@ee..e.e@@e.ee.e.e@e@e@...w
....@@ee.e@e..@e.e...@@e.e@.@@e.....
....e.@@e@e@.@e..@e@.ee@e@..ee.ee...
w....ee@e...ee@@ee@e.ee@e@ee.@e@@..w
.....@e@e..e@e@e@.e@e@e@e..@.e.@e...
..@e.e.@e@e.e.@e..@e@.@....e...e....
w.e@e@ee..e@@ee..e@..ee........@e..w
..e@@e@.e..e.@e@.ee.e@@e.e@....ee...
...e...e@e@e.e.e@@@ee@e...e@e@e@@...
w.....e@e@e@e..@ee..ee@.e@e..e.@e..w
...ee@e@...e@.....ee@.e.@e..@e.e@...
..e@@..e...@e....e@ee.@e....e.ee....
w.@eee@e@e...e@.e@@e@@e.....e@@@...w
..@e@@e.ee.e..e.@ee..e.......eeee@..
..eee@e.@@e@.@e..e@...e@@e@e@e@.@e..
w.e@e...e@@@ee........eee.e.e@.....w
..e@@ee..eee.@e...e.@e@e..e.e@..e...
...e@e@..........e@.e.e@e.@e.e..@e..
w....e@..e...e...@e..e@@e.....@e.@.w
.....@e@e@...@e.......ee@.....ee.e..
...e@e...@e.....e..e@e@..e@e..e@....
w....e..@e....e.@.e.e...e.e@e@e....w
....e@..e@.e@e@.ee@.....@e..........