33,36
365
365
1000
..e...e@ee@@e.@e.........e....e@ee..
w.@..ee@.@ee@.e.......e@e@e@e@@ee@.w
..e.e@.e.@e.e@...e@e@..eee@..e......
.....@e..e@.ee......e.e@@@...ee.....
w..e.e@e....@e.ee.e....@ee..e@@....w
..e@...@e..e@.e@@.@ee..eee..@eee.e..
...e.ee@@e@ee.@ee..@@..e@@e...e@e@..
w..@.@.ee@...@e@...ee.e@e@e@ee..@e.w
..eeee.e.e@.@ee.....e.e@ee..@@..e...
..@e@@e@e.e@e@@e..e.@ee@@@..ee..@e..
w.e....e@.....@e..@e.e.eee.ee..eee.w
..@ee....e...ee.....e@.@..e@@ee@@@..
..e.@..e@@e..@e....e@eee..e@@e@.ee..
w.@.e...e@e@@e.e.e@ee@@e..@ee..e@@.w
..e.@e.e..@eee.@e..e.......e@eee@e..
..@.e@.@e..e@@.e@@e@........e@@@....
w.e...e@e..eee@e.e@...e.e@e...ee...w
......@@ee.@@.e...@ee.@@e......e....
...e@.ee.@eee.@..ee.@.eee@e.e..@e...
w..@ee@e...@e.e.e@@eeee@e@.e@@e@...w
..e@.ee@e@e@e@.e@....@@e.e.e@e@ee@..
..@e.@...@e..e@@e....ee@e...ee...e..
w.e..e...e....e.........@e@e@@e..e.w
..@e..ee...e@e......e@e.e@@ee@e.e@..
...e@e@@e@e...e@e...e@e...ee@...e@..
w..eee@@e.........e@e.....@ee@...e.w
...@.@ee.e@..e@...e@@ee@e@e.@e..e@..
...e..e@..e..ee....e@e......e..e....
w......e@e.e@@eeeee..e@e.e@.@ee@.e.w
.......e@...e@e@@@@@e@ee.@ee@e@e@@..
.....e@@e..ee@e.eeee..@@e@ee@..eee..
w.....e....@e@e.@e.@eee..@e@e@e@@e.w
...........e@e....e@e@...e..e@ee@e..