33,36
364
364
1000
...e@ee@e@ee@ee@e...e@.e@eee.e@.....
w.e@..e@e@ee@.e...ee.e..e.@@e@e.e..w
......@e...@e.@e@.@@.@..@ee.e.@e@...
..@e...e...e@e@ee.ee.e..@e@.@.ee....
w.e....@@e@e.e@@e.@..@e.ee..e..@e..w
..e@e..ee.....e@e.e......@.....@e...
..e@e..e..@eee.@e@e.e....eee.@ee....
w.e...e@..ee@@.e.@e@@ee...@@@ee@@e.w
..@...e@e.@eee..ee.e@e@@e@eee...e...
..e.....@ee@@.e.@@e.e..e@.....e@e...
w..@e....ee.e.@ee..e...@e.e@..e@e..w
...e.e..e@@e@e@@@..@e..e@..eeee.e...
..@ee@e@e..e@.eee@ee@.e.e@ee@@@.@...
w.ee....ee@eee@@e@@..e@.@e...ee.ee.w
..e@eee@@e@.....@ee..@e..ee.e@@e@@..
...e@@eee.e....e@ee@ee@ee@@e@.e@.e..
w.e@@e......e@e@@e.@ee@@..@e..e@e..w
....e.......e@@ee..e@@ee..e......e..
...e@e@.....@ee.@e..e@e.e@e......@..
w.....ee.e@ee@@e.@.e@@ee@e..@ee@ee.w
...e..e@.@e.e@ee@e.e@e..e@..e.@@e@..
..e@..e@e@..@e@e@e@e@..e@e....eeee..
w.e@..@e.e..e.....@ee....@e....e@@.w
...e@ee@....@e@e@.ee@.e........e@e..
..e@e..@e...e@e.e...ee@.......ee.e..
w.@e...e..e@e@@e@..e@e@e...e@e@@e@.w
..e.......e@eee...e@e@e@.e..e....e..
..@ee@e..e@@e.@..e@......@e@e.e@e@..
w.@e.e...@ee.ee...@e.......e@.e.e@.w
..e@e@......e@....e@.......@e.@e.e..
............e@e@ee@........@e.......
w..ee....e@ee@e...e...e@e.ee.e..e@.w
..e@@e......e@e@e.@e@e....@e.@e..e..