33,36
366
366
1000
..@e....e@e.........e......e........
w.e.e@e.e@@.e......e@e@ee@.@..e.@e.w
..e..e@..eee@e.ee.e@ee@e.e.e@e@.e...
..@e@ee@ee@ee@e@@e..@e@@ee...e.e....
w..e.@@e..e@@ee@@e.e@eee@@e..@e@...w
...@.e.@e...e@.ee..@@e@e@...@e......
...e.ee....e@@e....ee.@ee..ee.......
w....@@e.....e...e.@..e...e@....ee.w
..e..ee@@e......e@.ee.e.e.e@ee.e@@..
..@.e@..e@.....e@.@e@e@.@@e..@e@ee..
w.e.@....e.e@e@eeee@.e@@ee....@ee@.w
....e@...@..@ee..@e@..ee......e..e..
...e.e..@ee@ee@....e@e@e@e......e@..
w.e@.ee@e.......e...e...ee..@e@@e..w
.....@.......eee@..e@..e@@e.eeee.e..
..@e.e..e.e@.@@ee.e@e..e.e@ee@..e@..
w.e@....@e.e.ee@@e@e@..@eee@....@e.w
....e@e@e@.....@e..ee@ee.@e@e@ee@e..
....e..@e.ee...e..e@@e@@..@e@..e....
w..e@e@e..@@ee@e......ee.......@...w
....e@@e.ee..@.e@e...e@..e@@e..e....
..e...e.e@@eeee@....ee@e..ee.e@ee...
w.@e....e@e@@...eee.@@e@........@e.w
.....@e..ee.e@ee@@@ee@ee....e@e@.e..
.....e@e@e@.e@eeee@@@.@@eee.e@@ee@..
w...e..@.e@.e@@@@eeeeee.e@@..e@@@e.w
....@eee@.ee.eee@..e@@..e@e..eee@e..
....e@@@ee@@e.e.ee@e@e@ee@e.e@......
w.....e..e@@ee@e@.ee@e@..e@..@e.@e.w
..........ee..e..e.@e.e@...e.e@.e...
...e@e.e@.....@e.@e....e.e.@e..e@...
w.e.e@eee....e@ee@e...e@e@@e@..e@e.w
..@e@ee@e@e...e@@e....@e..e....@e...