33,36
373
373
1000
..e@@e@e@...e@e...@e.....e@e...@e...
w..eeee.e...e.....e.e@.eee@e@e.e...w
.....@@e.e..@@e.e...@ee@@@e.@e.@....
..ee@ee..@e.eeee@e.e@e.@e@e.e..e....
w.@...@e.e@...@@e..e@..e.@ee@e@e.e.w
..e....e@@e...ee@...e@e..e.@ee@.e@..
.....e..e@.ee.e@@e...e@..e.e@.ee@...
w.e..@...ee@@ee@ee@..@e..@.@e@.e@e.w
..@e.ee...e@e@.eeeee@e@..ee@.ee.e...
..@e.e@.....e@.@@@.@e...e@ee@e@e@e..
w.ee@@ee@ee..e.eeee.@e@e@.e@.ee..@.w
....ee@...@e@..@ee@...e@@e...@@e.e..
.........ee.e..e........e@...ee.....
w........@ee...@e..e@e@.e@@eee@..e.w
....e@ee..e@ee@@e...e@e.eee@@e@e.@..
....e@e@..e@@@eee@.ee..e@..e@ee..e..
w.e@.e@e@e@ee.@..e@@@ee@e..@.e@@e@.w
...e.@........e.e.eee@e@@e@e..@e@...
.....e.e....e.@e@e@e@..e......ee....
w.@e..e@@e@.@e.e@e.@@e.ee@...e@@e..w
..e.e...e.e@@e@....ee.e@.e...e@@e...
...e@eeee.@ee.ee.@ee.....e....ee....
w.e@@e@@@.....e@.ee@.e@..@.@e..e...w
....eeeee.....e@......e..e.e..e@....
.....@@e@...e@ee..e....e@e.@e.@@ee..
w.e.ee..e.@ee.@e@e@.....e.e@..ee@@.w
..@.@eee@@e.@..........e@e.e.@e..e..
..e...@e@e..e@......@ee@e@e@.e.ee...
w.@e..e.e.@e.e.e@e@ee......e..e@@e.w
...ee@e@@ee..e@e@....e@e@e.@..e@@e..
...@@e.ee....ee.ee@@e@@e.e@e@..ee...
w..ee..@@e..e@@e..ee..e.ee@.eee.e..w
..e@@e.e@e.........@e..e@.e.e@@e@e..