33,36
372
372
1000
...ee.e@ee@e@...e@eee...e@e.........
w.e@@eee@...e...@ee@@...e@ee@...e..w
..e@@e@@e@e..ee@@e.@e.e@...ee@.e@...
...ee@....e@e@.eeeee...e..e@eee@.e..
w.e.....@e..e...e@@e...@e.@....e@@.w
..@ee@e@e..e@.e.e@e.e.e@@.e@e...ee..
..e..e@ee....e@e.@ee@.eee..ee@e@e...
w.@..e@@@...e@@e.e...e@...e@@eee...w
..e...eee..e@.ee..eee@..e..ee@@@ee..
..@e........ee@@..@@e@@e@.e@@eee@@..
w...e@e...e@@e.e@eee@eee...e..e@@e.w
..e.e@e...@e@e.e@e.....@e@e@@ee@ee..
..@.e@ee@ee....e@.e@e.e...e@eee..@..
w.e.......@.e@..e.@e.e@....ee@@e.e.w
..@..e@e..e..ee..e@e@ee...e@.e@.e@..
..e.....e.@e.e@.....e.@e@e@@e.e.e@..
w.e....e@.e.eee@ee@e@.e.@e.e..e..e.w
..@e.@ee@e@.@@.e@@ee@ee.ee.e..@.....
...e@e@e@e..ee.@@e.@e.@..@e@..e@....
w...e...e......ee...e@ee@e@....e...w
..ee@...@@e.e..e@ee@e..@e......eee..
..@e@ee@ee.e@..@.@@e@@e@.e@.e@e@@@..
w.@e@e@e@e@e@..e.e..@e.e..e@e@e.ee.w
..ee@e@e....e...e...e......e@@e.....
..ee@@e...ee.e..@e.e..e......e...e..
w.@ee@@e.e@@e@....e@..@e...e.e@.e@.w
..e@.e.e@@ee.@e.e@@e.@e.e..@e.e@e@..
....e...ee@@ee@..e.e@e..@..e@...@e..
w..e@e.@e.e@.......@e...e.....@e...w
...@e@.e@e@e....e@@e.......e..e@e...
..ee...e@........ee.ee..e..@e.e@@e..
w.@e.e..ee@.....e@ee@@e@@e@ee..e@e.w
..e.e@....e.......@e...e@e.e@.......