33,36
354
354
1000
..@e@....@ee@....e@e@ee@.......e@e..
w.e.ee@eee.@e....@ee@.@e...e...@e..w
..e...@e@.e@e@e.....e.e@..e@e@e..e..
..@e..e...e@e.e.e........e@@e@ee@@..
w.......e.@e.e@e@e.....e..ee@...ee.w
..e@e.ee@e@@e.e@@ee....@e.@....e@@..
..@@e.@..@e..eeee.@e..e@@.e....@.e..
w.ee..e.e@@.e@@@@...e@eee......ee..w
..e@..@e.ee..@eeee@.......e@...@@e..
.....e@@.....e.e.@e.....e@ee...e@e..
w.e..@eee......@.......e@@e..eee@e.w
..@e@...@e.e@e@e.e@......e..e@@@e@..
..e.e..e@...e@.@..ee@ee.e.e@.@e.....
w.ee@e.ee.ee..ee....@e@e@@eeee@e@e.w
..@@e@.@.e@@e.@ee@..e@@e@e.@@ee@e...
..ee..ee..e@e....ee@e.e....e.e@.@...
w..ee.@@@e@@e.e..@ee@......@e.e.e..w
..e@@eeeee.ee@@.e@@@ee@e...e@e@.@e..
..e@e..ee@.eeee@eeeee@e@.e@ee@e.....
w.@e...@e@.@@e@eee@@@..ee@@e@.@@e..w
.......e.e@e@..@@@eeee.@@ee...ee.e..
.........@e.e..ee.e@@@eee@....@..@..
w........e@....@.e@@e@.ee@ee..e@ee.w
.....ee@e@@e.e@ee@@e.e@@..e@..e.....
....e@@e..e@e@..e@e..eee..@...@e.e..
w.@ee@e...e@..e.@e...@e@..e@e.eee@.w
..eee@.....e..@e@@e.e@ee@ee@ee@@e...
..@@.e....ee..eee@e....@e....e@e.e..
w.ee.@e...@@e.e@...e....@e......e@.w
.......e@ee@..e@e..@@ee@.....e@ee@..
.......@ee.e..e@e@.ee.@e.....@e..e..
w.......e@.....eee.....@...........w
........e@e@e@ee@@e....e............