33,36
360
360
1000
..e@@e.@ee@e.e@e@e@.e.e@e@e.e@e.....
w..eee@ee@....e.@eee@.......@eee@e.w
..e@@e.......e@.e@@e...e@e.e@@@e....
..ee@@..e..e@e.e@e......e@..ee@@....
w.@eeee@@e..e@.@e@e.e@...@e.@eee...w
..e.@e.e.@.e@ee@e.@eee...e..e@...e..
..@ee@ee@e@@e....e@@@@e...e@....e@..
w.@e@e@@e.ee@.e@e@eee.ee..ee.......w
..ee@ee@e.e...e@@....e@@ee@.........
....e@...e@..e@ee....ee@.e@e..e@....
w..e@....e@e.@..ee..e@ee..e@e..e...w
..e@.e@e.e@@ee.e@@.e@.....@...@e....
.....e....e.e@.e@e..e.e..@e..@e@@e..
w.e@e@.@e...@e...@..@e@.ee@..ee@e@.w
..e@..ee@..e@e...ee.....@.e.....e...
...ee@@e@..@e@.e..@..e..e.@...e@@e..
w....e..eee@eee@..e.e@.e..e....e@..w
...ee@...@e.@@..@e.e@e.@...e@e.ee...
...@e...e@@eee.ee@.@e..e...e@ee@....
w.e@ee@e.e@e...@e....ee@eeee@e@@e..w
...@ee...e@@..e@e...e@.e@@@.e..e....
...ee@e.e.ee...@e.e@e@e@.ee....@e...
w...@e.e@.@e...e.ee@e@.@e..ee...@e.w
..ee@e.@e.e@.e@@e@.e.e.ee..@@e@ee@..
..@.e@..e@@e..e..e@@@ee@@e.e@..@e...
w.ee@.@eee..e.@e@eeee@e@e...e@e..e.w
.....ee.@e..@e......@.@e...e....e@..
..ee@@e....e........ee@e...@e...@e..
w.@.e.e....@e.......@e@e...........w
..e.e.@e...e@....ee.@e.....e@e..e...
....@.@e.e.@.e..e@@ee..e...ee@e.@e..
w..@e.e..@ee@@e@ee@e..e@@e.@@e@.e@.w
...e.....e@.e@e.e@.@e.e@e..e@e......