33,36
363
363
1000
..e............e@e.........@e@@ee@..
w.@e.@e....e..@e....e@e@ee@e.eeeee.w
..e@.e.eee.@eee..e.e@.e@..e..ee@@...
..e...e@@@e.e@@e.@eee.@e.e@e.@e@e...
w.@e@.e@e@ee@e.e..e@@ee..e@@.e.e@e.w
....e.e@e.e@e@.@e.@e@.@e..eee...e@..
..ee@e@e.....e.@eee.e.e@..@e@@e@e...
w.@e..e@.e@e@@eee@....@e@ee@.e.e@..w
......@..@e.e..e@......e@e@@e@e..e..
....e@eee@e.e..............e..@e.@..
w.e.e@@@e@@e@e@ee@e@e...@ee....e.e.w
..@e.ee.ee@e@..ee@@e.e@.e.@e..e@....
..e@..@e@.e@eee@.e.e.@e..ee@@e@.....
w.....e.e@...@ee@ee@....e@..e@.e@..w
......e@@e..e@.@e@........@e....e...
...e@e@e.e@e.e@e......e...e.........
w...@e@e.@@e.......e@e@.e..........w
....e...@ee@...e@e.e@e@e@.....e@....
....@eeee@..e..@ee@@e.e.....e..e....
w..eee@@e..e@..e@ee@ee@e@e..@e.@e..w
..e@.....@e.@e..e@@......@eeeee.e...
..@e...e.e..e..e@.e.e@ee@e@@@@@.@e..
w..@e@.@e@.e@.e.....@e..e.@eeeee@@.w
...e.e.@e.....@e....e...@.e.e@..ee..
.....@eee...eee@ee.e@...e..e....@e..
w.@e.@ee@e..@@@.@@@e@......@.e.....w
..e..ee@e@e.eee.eee.e.ee..@e.@.ee@..
..@@e@@...@ee..e@ee@e@@@e@e..e.@ee..
w.eee.e...e@@e@ee@.e.ee....e.......w
..e.@e.e@e.e@e.@.@ee.e@@e@e@..e@e...
..@e.@eee..@ee@e.ee@.e@e....e@e@....
w.@e.ee@@e.e@.......e.........eee@.w
..e..@eee@......e@ee@.e@e@e..e@..e..