33,36
349
349
1000
....ee.e....e.e@eee@e...e@ee@@e@....
w.e@@@e@e@e.@....@e@e.e@@e@.ee.e@e.w
..@ee@e@@@e.e...e..@e@@e@e...e@.....
..@e.e.eeee...e.@..e.e.e@@..e.e@e@..
w.e@e...e@@..e@.e.e..e@@ee..@.@..e.w
...e@..ee@e..e@ee.@...ee@@.@e.e@e...
...@e@e@@e......@ee@e..e.e.e...@e...
w.e@ee.e@@e@....e@e@@ee@..e....eee.w
...@e@..e..e.e..@e@e.e...e@....e@@..
...e......@e.@e..e..e@e.e@@e..e@ee..
w..e@e....e@e@e..@.e@.@...e..e@.@..w
...e@@e...@ee@@e.e....e.......@ee...
....e..e@e...e@e......@.......e.....
w.....e.@e.ee.@e....e.e.....ee@....w
...e..@.e.e@@ee.....@e@.....@@e.e...
...@e@ee@.ee@@ee......@e..e@e@e.@e..
w...@e@..e@@ee@@ee....e..e@ee@..@e.w
..e@e....e@e....@@..ee..e@@eee..e...
...e@....ee@....ee@.@@e.e@e@@@ee.e..
w........@.e@@e...eeee.e@@eeeee@e@.w
....e@.e.e..ee....e@e@..@e.@.@eee...
.....e@@e.@ee@....@ee@e.ee@ee@e@@e..
w.....e...e@@e...ee@@e.e@@e.@ee@@e.w
..e........e.e...@eee@e.e@@...@ee...
..@e...e@e.@e@..e@.@ee@..ee@ee@@e...
w.e.e@.e@ee@e@e..ee@e.@e@...@@e....w
..@e.e....e@..........eee@e.e.ee....
...e..e...@e@ee@e@e....@e.@e.e@@ee..
w..@e@@ee@e.e@@e@..e......e@.e@ee@.w
...e@e@eeee..e@e..e@.....e@....@@e..
......e@@@@e@.e@.e......e@..@e.e....
w.....@eee..ee@..@e....e@@eeee.....w
.............@e.e@e......e.@e@.e@e..