33,36
367
367
1000
....e@e....@ee.e@e.e@e...e@e@e@e@e..
w....e..ee.e.@.e@e.@.....e@.e.@ee..w
...e@@.e@@e..e.@...e...e..eeeee.....
....eeee@e...e.ee..e..e@@ee@@@e.....
w...e@@e@e...@e.@e.@....e@..e@ee.e.w
....e@e.....e@..e@.e.e@.@e..ee@@e@..
...e@.e@.....e@ee....@ee@@e.@e@.....
w..e..@eeee@e...@.e@e@e.e..e@eee@e.w
...@e..e@@e@@e@ee...@...e..@e..e@e..
..e@@e@@.@ee........e@e@@..e..e.....
w..e@eee.e@@ee.e.ee..e@ee..@e@@e...w
..e@.e@@e..e@@e@e@@e.e@.@.e@ee......
..@e.e@ee...e@e@@e@e.ee.e.@e@...e@..
w.e@.ee@@e.e@..ee..e@@e.e@e..e@e@e.w
...e.@e@e.@e...e@...e@@...e...@e@e..
..e@...e@.e..........ee..e@@e.e..e..
w....e@@e..e....e...ee.....ee.@e@@.w
....e@e@e..@e.e.@e.e@@ee...e@...ee..
.....e.e..e@e@@e@..@e..@e@e@e@e@e...
w..e@ee@ee.e@ee.e..e@@ee.e..ee.e@e.w
...@..@..@e..e.....@.eee...e@@e..@..
...e..e..e@e.@e....ee@@@e..e@e@..e..
w..@e...e.e@....ee...@e.@e.e@ee@e..w
..e@eeee@e@ee..e@@e..e.e@e.e@.......
..@.e@@e...@@e.e@e.....e@ee@e..@e...
w.e.e@@e@e@e...@@ee@.e@e..@e.e.e...w
..@..ee@....ee.ee..e.e@e@e@e.@.@....
..e.e.e@e...@@e@.....e@e.e...e.eee..
w...@e.e@.e@e.@@e...e@e@.@.....e@@.w
.......ee@@e..ee....e@eeeee@...@ee..
....ee@@.ee@..@e..e@e..@@e.e.....@..
w...@@ee.@@e.e@ee@ee@..e..e@...@ee.w
....e....e@e...........e@ee@e..e....