33,36
360
360
1000
...e@eeee.e@......e@@e..e@@e@e@.....
w.....@@@e.ee..e..eee..e@ee..ee....w
......ee.ee@@e@@.e@..e@@e@@.e@@.....
.........@e...ee.@e..@e@e.e.e@e.....
w......@e.......e..e.....e..@......w
.....e.e@@e....e@e@@e....@eee.......
....e@.@ee...e.@e@e.e......@ee......
w.e.e@ee@@eee@e@e@.e@@e....e@@e@e..w
..@@e@e@...@e..@ee...e.e..ee..e@ee..
..eee@........@e.@ee..e@@e@@e...e@..
w..e.ee..@e@e.e..e@@e@eee.e@e.e@e@.w
...@..@eee@e@.....e@ee@@@e@@e.@e.e..
..@e.e@e@@e.....eee@e..e@e.e.....e..
w.e.ee@@e@ee@e.e@@e....e@.@e....e@.w
....@eeee@@e..ee@@e.@ee.e@e.........
...e@e...e@@ee@eee..e@@e@........e..
w.......e.e@@@e@.e..e.ee@eee...e.@.w
..ee...e@e@eee...@ee@.@@e@@@...@ee..
..@@ee@ee@@e....e@e...e..@ee..e.....
w.e..@e@@eee@e@e...e@e@e.e.@e.@e@e.w
......ee@e@.e..@...e@..@e@e@..e.e...
.....e@....e@..e...ee@.e@.@ee@e.@e..
w...e.@e@e@e......e@.e.e@e.e@e@....w
....@ee.e@.@e.....e@e@e@...@ee@.e@..
...e@@.e.ee@e...e..e.e.....@e.e..e..
w..@eee@e@@..e..@e@e@@e...@e@..e...w
..e@e..@e.e.e@.ee@eeee....e....@e...
..e@e..e...e...@e.e@.@e..e@e..e@ee..
w..e@.....e@..e@e.e...e@e@@e.@e.e@.w
...e@ee..e@@e.e@@e@..e....e@.e..e@..
...e@@@..e@ee..e@@eee@..eee@e.e..e..
w.e.eee..@e.@e..e@e@@e@.@@.e@.@....w
..@e.............e.e@ee.ee.e@ee.....