33,36
363
363
1000
..@eeee.....@e.e@.e@e@..e@@e........
w.e.@@@e...ee...e@.e.e...eee@e@e...w
..@.ee.e..e@...e.e..ee.e..e@ee@e....
..ee..e@...ee.e@...e@@e@.e@@ee@.....
w..@....e@e@@e@.....e..e.e@e..e@e..w
...e.....e.ee.......@e.@e.@e..@.@e..
..@e.e@...e@@ee@e@eee..e@.e...eee@..
w.e@..e@e@ee..@e@.e@@ee@.e.ee.e@...w
....@eee@ee@...e@e..e@e..@e@@.e.....
..e.ee@@e.@e...e....e@@..e..ee@e....
w.@e.@..@e@e...@ee@eeee..e..e@@ee..w
..@e.e..ee@@.......e@@...@@e..ee@...
..e.e....eee@ee.e@.e@e...ee@.e@@e...
w...@e...@...e@e.e.e@@e..........e.w
.......@ee.e.@e.....e.@ee...e@e.e@..
.....e@e.@e@......@e@.e@@e.@e.@e@e..
w....e..e@e@e.....e....e@@ee@e@.e..w
.....@e@e@e@e@e.e..e....e@...eee@...
......@ee..e@..e@..@e...@ee.e@......
w.....e@@e..eeee@ee@e.ee@@@e.......w
........e.@e@@@e@ee@.e@@ee..........
..@e...e@.ee@ee.ee.e@e...@ee@e.e@e..
w.e...e@..@eee.e@@e@ee@e.ee...e@@e.w
....e.e@...e@@e..e.e@.e@.@@e....e@..
..e@@e@e.ee@@e@..@......eee@e.@e....
w.ee@@...@e.e..e@ee....e@e..@eee.e.w
..@eee...@e@.e.@e@@....@@e.e@..@e@..
....@e...e@ee@..e@e@e@.ee...e....e..
w....e@e@..e@e@e@.e@ee..ee@e...e@@.w
.....@.eee.@e..@..e@@@e@@e..eee.ee..
.....ee@@@ee@e@ee..eee.e@...@@@e@@..
w..e.@..e@e..ee@@@e..@..e@..eeee@e.w
...@ee..e@e.e@@eee...e...e...e@.....