33,36
368
368
1000
..e@e..e......@e.e@e..e..e@@e.......
w.e....@e.....e.@ee@.e@...ee.....e.w
..@e.....e....e.e.ee@.e@@ee@....e@..
........e@...e@..e@.e..ee@e..e..@...
w.e...@e@..ee@.e@e@e.....e@..@e@e..w
..@e..e...e@.e...e@@e@ee@e...e.e....
..ee@.e@.e.@e..e..e@...@@e@..@e@....
w.@ee..e.@ee...@...e...ee.e.e@e@ee.w
..@e..........@e....e......e@e@@e@..
..eee....@e...ee@e@.@e.ee@ee@e.e@...
w.e@@ee@ee......@eee@ee@@e@........w
..@.e@ee.@ee@e.@e@.....@e.e@...ee...
..e.@.@@e.@@@e@e.......e..@e...@@e..
w...e.ee@.eee.....e...eee@e..eeee@.w
.......@e..e..ee.e@..e@@..e@e@@@e@..
...ee.e..e@@e.@@e@...@@e.e...@e@ee..
w.e@@e@...e@e.e@e....ee..@e..ee@e@.w
...e@e@e@e.....@e..e@ee@e@ee@e.eee..
...e@@ee@......e.......ee@.....@@@..
w..@e.@ee@e........e@eeeee.....eee.w
..ee...@@e.eee@e...e@@@@@e.e....ee..
..@@...e@ee@@e.@e..@eeee@@.@e...@@..
w.eee..ee.e@..e@e.......eeee@...ee.w
...e@e.@@e.e@e....ee@@e...@e@.ee@...
..e@.e.e.@ee@e.e@e@eeee..e@eee@.....
w.e..@e@..@ee..e@.e@e@@...e@.e.....w
..@e..e@e..e@e..e.@ee@e...@ee@ee@e..
..e..e.@eee@ee.e@e@.e@.e@..@e@@ee@..
w.@ee@.e@@e@@@e.eee..e.ee.e@@e@@ee.w
....@..e@e@ee.e@@@e....@ee@e..e@e@..
...ee..e@e.ee..ee.@e.....@.e@e@.....
w.e@.eee@ee@@.e@ee..e....e.....e...w
..@ee@@e@e..e..e@@ee@...e@.....@e...