33,36
363
363
1000
...e@e..@e..eee@e@e@..e@e@e@e...ee..
w..@e...e...@@e@e@.ee..e.e.e@.ee@e.w
...@e.......e@ee.e.e@...e@e@..@@e@..
...ee@e@.....e..e@e..e@e@@e...e.....
w.e...ee....e@ee@e@e.ee..e.........w
..@..e@e@..ee@@eeee@e@e...@ee@.@ee..
..ee...ee.e@@ee@@@@e@@e..ee..e@ee@..
w.e@..e@..@eee@.ee@e.ee.e@@e@@.e@e.w
.....ee@e..e@.....e@.e@ee@..ee.e@e..
....e@@e..ee@.....e@e@@e.ee..@......
w...e@e@.e@.e@e...@ee@e.ee@e@e.....w
...e.ee@@e.e@ee....@@e..@@@e..e@....
...@e..ee..@e@@@ee@e.@e@eee@.e.ee@..
w.e@e..@e..e..ee.e@ee.e@.@..e@.e.e.w
...e@..............e@.@e.e..e@e@.e..
......e..@e@e...@e@e@e@@e...@e..e@..
w..e.e@.@ee@..@ee..@eee..eee@e.....w
..e@e@e.e.@e..e..e..e@..e@@.........
..e@@e@.e@@e.....@ee.e@...e@e@...e..
w..e@e.@eeee..ee.@e@e@e..@e@eee@e@.w
..e@@e.e...@.e@@@e.e@@e..ee@..e.@...
...@e......e...eee..@e....@e..@ee...
w..e..@e.@e...e@@@e.ee@e@.e@...@...w
.....eee.e....e@e@....e@e.@...ee....
..@ee@@@e@.ee.e@ee........ee@e@.....
w.ee..e@e.e@@.e@e...@e....e@e@e@e..w
..e@......@eee@e....e....ee..@ee....
..@@e.......@@........e.e@@..ee@e@..
w.ee@...e@..ee...e..ee@..@e..@e@.e.w
..e@..e..ee@e....@ee@@e..e@....e.@..
......@e..@e.eeeee@......@e@@e.e@e..
w.e..e@e...ee@@@@..ee......ee......w
..@ee@e.e@e@@eeee.e@@e........e@e...