33,36
353
353
1000
..@e@e...e@ee.e..@e.e@ee..ee@e.@e...
w.e.....e@e@@e@..ee.@@e@.e@@e..e@..w
.....e@e@@e.e@...e@.ee...@e@@.......
...@e..@ee@..@ee@@e....e..eee..e@...
w..e..ee.....e@.e@e@e..@.e@.@...e..w
....e.@@e....ee..e.....e....e@ee....
..ee@.e@...e.@@e..e@e........@e@.e..
w.@....ee..@@e....e@e@e@ee@e.e@..@.w
..e....e@..ee.....e@e.....@e....ee..
..@.....ee....e.e....e.e@.e@..e.@...
w.e.e@ee@@e...@e@....@e@e.e@ee@.e..w
..@e.@e@@e@...e@.....@e.@e...@e@.e..
..e@eeeeee@e..@...ee.e.......e.ee@..
w...@e@@...ee.e@ee@@.e@e........@e.w
....ee@e@e.@@@e...@ee@e@ee@e....e...
..e..@ee@@.eee....ee@.e@@e@ee@e@....
w.@ee@..ee@e@....e@e@..e@@e@.e@e...w
..@e.e@e.e.....ee...ee@.e..e@e.@....
..e..@e..@e.e@e@@e.e@.e.@ee@.e@e@e..
w....ee@e@e..e@e...........e@e@eee.w
....e@@eee..@ee@.eee.....e@.e.e@@@..
..e@ee@e@@..ee@.e@@@e@.e@ee.@e@@ee..
w.....e.ee......@@e@eee@..ee..ee...w
........@@e@ee@eee.e...e@e@@.e@.e@..
.....e@ee.e@@e@e...@e..@ee@e.@e.ee..
w....@e...eeee@@e@e@..@e.e@eee@e@@.w
..........@e..ee.@eeeee...e@@e...e..
...@e...e........e..@@@e@.@@e.......
w..e..e.@.....@e@..@eee.e.ee.......w
.....e@.ee.e@.e.e..e@e@.@ee@........
...e.e@e@@..e..ee@e@..@e@e...e......
w.e@e@ee@e..@e.@ee@.eee@....e@.ee..w
...e@.@ee@..e@.....e@@e....e@.e@@e..