33,36
358
358
1000
..@e.eee@.e@e@ee@e.....@eee.e@e.....
w.ee.@@ee.@ee.....e....e.@@@e....e.w
..e@.e@@e...@e.@e@@ee....eee.@e.e@..
..@e..e..e...e@e@e@e@.....@e.e@e@e..
w.@e.e@.e@........e@@e....e@..e@e..w
..e..e@e......@e.e@@e@..e.e.e..e@...
........e@e@e.e@.e@e...e@.@.@.e@....
w.e.e@e.ee@.@..e@@e.e.ee..e.e.e@e..w
..@e@.e@@ee@e...e..e@e@@.e@.e.......
..e....e.@e@e...e@e@e.@e....@..@e...
w.@e...e@e....e..e..@ee.....e..e...w
..eee@.@e..e.e@e@@e...e@..e....@ee..
..@@@e.e@e.@e..ee.....ee@.@e....e@..
w.ee.....@ee@..@e.....@eee@@e...e@.w
...@e...e@@e....e@ee@e.e@eee@...ee..
.........e@.e@e@@.@...ee@@@@e..e@e..
w.....@eeee.@.eee@e.ee@.eeee...ee@.w
......ee@@..e.@e@...@......@eee@e@..
.....e@e@ee..e@.e@e.e....@e@@@e@ee..
w.ee.e@..e@@eee...e.....@e.ee...@e.w
..@@e@e....e.@e...@.....e....ee.e...
..ee@..e.e...e@@e.e...ee....e@@e@...
w.@e..e@.@e.e@.ee@e@ee@@.@ee..e@ee.w
.....e.....e.@e...e.@e@e.e@@..@.@@..
...ee@.....@ee..ee@@e@e....e..e.ee..
w.e@@ee@..e..ee.@@eeee@e@e.@ee@....w
..@e@e@e.e@..@@ee..e@@@e.e@e.....e..
......e@.e.e@e@e...e@ee..eee@....@..
w.e..e@.e@.@ee@e@e...@@ee@@@e....e.w
..@ee@e@@ee@@ee@e@...e@e@.e......@..
..@ee@ee...e@e.@e...e..e@e@..@e@ee..
w.e...e...ee...e@.e.@.e..@...e..e..w
..e@e.@e.e@@e....e@.e.@e.e......@e..