33,36
372
372
1000
....e.............e@e....e@e@e.@e...
w..e@..e....e.@e@e.e@.e@e.ee@@.e...w
..e..ee@@e..@.e..e@e...@e@e.ee.e@e..
..@e@@e@e..ee.@......e.e@e@e.@......
w...e...@..@eee......@e@...@.e.e@e.w
...@e@e@e@e.e@@e..e..e.e@e.e.@ee@e..
...eee@@e.@.@e@..e@e...@e.ee.e@@ee..
w.ee@@ee..eee.e..e@@e....e@@@e..e@.w
..@ee@@e.ee@e@e...e.@ee...@ee...e@..
.....e..e@..@e...e@@e.@e@.e...e..e..
w...e......e@e...e@e..@ee.@e@.@e...w
....@ee..e@e.e@e@e....e.....e..e....
..e.e@@ee.e...e@..e@@e@@e...e@.@@e..
w.@ee@ee@.@e..e@ee.ee@.e.ee..e.ee..w
.....e@e@e@..e@ee@ee@..ee@@e@.e@@e..
.....e@...e.e@e@@.e@@ee@e@e@ee...@..
w.ee@eee....@e..e.e@e.@e@..e@@e.@e.w
..@e@e.@e..e...e@..@e..e@.eeee@.e...
.....e@....@e@..@e.ee@..ee@@@@.e@e..
w..e@.e......ee.e..e.eeee..eeee@e..w
....e........@@e...@.e@@@@e...e@@e..
..e...e....e@e.....e.e@eee..eeee....
w.@e.e@e....ee@.e..e.e@e...e@@@@...w
......e@...e@@ee@@e@....e....eee@e..
......@.......e@.e...e@e@..e@e......
w.@ee.e...........ee@e@e@..e@e.....w
..ee@....@e.e@e...@ee.@ee..e@e......
..@e@ee@ee...e@..e@e@@ee@e.e@e......
w..e@e...e........e.ee.@e....e@ee..w
..e@e@...@e@e.ee@..e@@ee....e.e@@e..
..e@e.ee@eeee@@ee@eee@@@....@.eee...
w.e@ee@@@e@@@e@e@e.@@eee@ee@e.@@@e.w
.....@eee..e.e@ee@.ee@....e@e@ee....