33,36
362
362
1000
.....e...e@..........e@.e@..........
w.e..@....ee@e@.e@...ee@.e.........w
..@@ee.....e@ee@@ee.e@.e.e@e@e@@e...
..ee......e@@e.e@.@..e....ee@eeee...
w.e.ee@...@.ee@.e.e@e@...e.e@@.e@e.w
..@e@.e@e@e@e@eeee..e@e.e@.eee.e@@..
..e@@e@e.e.e@@e@@@@e..e@e@e@@...ee..
w.eeee...@.e@e..eee...@e...ee..ee@.w
..@@e@..ee.e@e....@..e@e.ee@@e.@.e..
..eee@e.@e.e@@....e.e.@ee@e@...ee@..
w.@e.e@...e.ee...@e.@.e.e@ee.......w
..@e......@e@....e..e.....e.....e...
..e........e@@e........e@e@....e@e..
w..e.eee@...ee.e...............e.@.w
...@e@@eee..@e.@........@ee@e@.@ee..
..ee@..@e@@e@..ee.e.....e..e.ee@e@..
w.@@e..@eee.ee.@@e@.e@e....@eee@e..w
..e....e.@ee@@.e..e@@..e@e.e.@@e....
...e@e...e@@ee.@e@.ee@...e@@ee@e....
w....@e..@ee@...@e...e....e.....e..w
..e.e.....e....e@e@ee@......e.e.@e..
..@e@....e@ee...e@...@e@e@..@.@.@e..
w...@e..e@..@@e@e@e..e@@eeeee.e@e..w
....e.e@..eeeee@e....e@e@e@@ee@e....
.......e..@@e@@e@e@e.e@e@@@e...@e...
w.e..eee@ee.e@@e.e@.ee@.eee...e@...w
..@..@@.e@@..ee@..ee@@e.....@eeee@..
..e@.ee@e@e..e@e..@eee@.....ee@..e..
w.ee@@@ee@e.e@....e@@e..e@e@.@e....w
..@.eee@.e@.e@e..e@e.....e.e.e@e....
..e.e@.@ee@e..e..e@@e@e.e@ee...@e@..
w...@..e.e@@e@@...e.@@e@ee@@e.ee.e.w
....e.....ee@ee.e@e.ee....e@ee@@e...