33,36
365
365
1000
...e@e.........e@e..e@e@e@@e...@e...
w..e@e@ee@e.........@e.e.eee...ee@.w
..@ee@@e..@e.e@.@e@..ee.e@@@e...@e..
..e..@e...ee@ee.e.eee@@e@.ee@e..e...
w.@..e...e@....e@..@e.e.@e.@ee.....w
..e.e.....@e....e.e@@ee@e.e.e@@e....
..e.@e.@e.e@@e.e@.@e@..ee.@.@.e.ee..
w.@e@e@e....e@.ee...e.e@@ee.ee@e@@.w
....ee@e..@e..e@@e@e@..e@e...@e..e..
.....e@ee.e....e@e.e.e@e@e@ee@e.e@..
w....e@e@......e@e.@e.e.e@..e@e.e@.w
.......@e.e..e@e.@e...@..e@e@....e..
.....e.e@.@e@e........e..ee......e..
w...e@e@e@ee@e...@e.....e@@e@.e.e@.w
......@e.........e.e@e....e@ee@ee...
......@e.e...e@..ee@@e@.ee@..@ee@...
w..@e.e@.@e...e.e@@.e.e.@....@ee...w
...e.......@e.e@e.e.e@e.e@e..e@@e...
...@.@e..e.ee@e...e@e@e.e@e...e.@...
w..e.e.e.@e@e....e.e@@e..@ee@.@eee.w
..e@..e@.e@@e.e..@e..e...e@@e..e@@..
..@...@e.@.ee.@e.e@.e...e@e....e@e..
w.ee@....e.e@e@ee@@e@.e..e@@e.e@e..w
..e@e@....e@@e..e.e...@e...e.e@e@...
..@e.e..ee..e@ee@.@eeee.e.....e..e..
w...e..e@@@e.e@...e@@@@e@.e...@e@@.w
...e@..e@ee....ee@@eeee@ee@e@ee.ee..
....e@.e@....ee@.e...@@e@@ee@e......
w...@e.@e...e@@ee.e@ee...e@....eee.w
..e@eee....ee..e@e@e..e.......e@@@..
.....@@.@e.@@e...e@@e@@ee....e@@ee..
w.@e.ee.e@.e@.ee@.ee.e@@@e.e.e.e...w
..e..e@e@..@ee@@e.e@..ee@ee@e@......