33,36
357
357
1000
...........e@ee@e....@eee.@e..e@....
w..e..@e@...e@.e@e@..ee@@eeee..e...w
..e@..e@e.e.@e..e@ee@e@@e@e@@e......
..@@eeee@e@..@..@.@eee.e.@e.e.......
w.ee.@@@ee@@eee.ee@.e@@eee.e@......w
..ee@eee..ee@e@..@e.@.e.@@e.....e@..
..@.e@@@e.eeee@.e@@@e@e.e.e...e..e..
w.e@e.ee.e@@@.e.@eee..@ee@@...@....w
......e@e@@ee....@e......eee..e.....
..@e....@ee.@e.@e....e@....@........
w.e@.ee..@..e..e.e@e..eeeeee@......w
....e@@e@e..@ee@..e@eee@@@@@e..e....
..@e.........@e...e@@@..eee.@e.@....
w.e..e.@e......e..@eee.@e@.e@eee...w
..@e.@ee......e@e......ee.....@@....
....e@@.ee@.eee@@..@e...@e...eee....
w.e@.ee.@eee@@@eee@e...e@e...@e....w
..@eee...e@e@e...e@.ee.@.e..e@e.....
..@e@@e.e.e@@ee..@ee@@.e.@e@e@.e....
w.e.e@@e@.@@e@@e.....e@e.eee.e.@e..w
..e@eee...eeee@e........e@@@e....e..
..e.ee@e@e.e@@.@e.@ee@..@ee.....e@..
w.@.@e@e@..e@e..@ee@.e.ee@@ee...@e.w
..e@e@e.e.....e...@e.@e@...e@.......
...e......e@..@...eee...............
w.e@..e...eee@e@ee@@@e.e.e@....e@e.w
..@e..@@ee@.e@e...@e..e@@ee.e@e.....
..e@..ee@e@ee@@e..e..e@ee....@eee...
w...e..e.e.@ee@.e@e.e@e@@e.e@e.@@e.w
...e@..@e@.e@.e.@....@e..@.e...e.@..
...e@.e@e@e@....e....e...e.@@e..ee..
w.e@e@..e@....e@.....e@e@..eeeee@..w
..@e.ee@ee.....e.......@e...e@@e@e..