33,36
367
367
1000
..@e.@e@e@e@.ee.......@e@ee@@e......
w.e.ee.e...ee@@e....e@e...eee.e@e@.w
..ee@......ee.......e@e.ee@@@e.e@e..
..@@e.e.e..@@e..e...e@ee@@ee...@....
w.e...@e@..e@e..@e..ee@e@ee@e@ee...w
..@...e@@e..@e..e@.e@e..e@@e@.......
..e.e@e.e..ee@e@...@e@...e@..e@e@...
w.@.@e@....@e@.e.e@e.e@e@.e..@.@e..w
..e...e..e@eee..........e..e@e..e...
..@..e@e..e@@.@e@....@e...@e@...@e..
w.e...e@....e.e.e@...e....eee....e.w
.....e@.........@e...ee..ee@.....@..
...@ee@e@.e.ee..e..@e@@e@@e@e....e..
w.ee..e@ee@.@@ee@..e.@e.ee@...e@.e.w
..@e@@ee@@e.e@ee@e..ee..@@e....e.@..
..e@ee.e@e..@@e@.ee@@e..ee@..e@e.e..
w.e@e@e@e@..ee.e.@.ee....e@e.ee@.@.w
..ee@ee@ee.....@ee.e@e....@ee@e@.e..
..@e.@e@e@e@......@e.@e...e.@@ee....
w......ee@ee.ee@e.e.e@e..e@.eee@e..w
.......e@@e@e@@e..@e@....e@e..@e@...
..e......e...e..e..ee....e@.@e@.....
w.@e.....ee..@e@@..@@.....e.e.eee..w
..@e...e.@@@e@eee..ee..e..e@e@e@@e..
..e.e.e@eeee@.e...e.e.e@..ee@e@e@e..
w...@.@e@.@e..@e..@.@ee@e@@@ee..ee.w
....e.e..ee@e@..e@ee@ee@eeee@@ee@@..
..ee@...e@e@ee..e....e@@e@..e....e..
w.@@..e.@ee@e...@e...e.ee..e@.ee@e.w
..eee.@.e@..........e@e.@.e@e@@e@e..
...e@ee.ee......e..e@...e....e@e@e..
w..e@@e.@@ee...e@.@e@........@ee@e.w
....ee@.ee@@e..e@ee.ee@e.......e@e..