33,36
359
359
1000
.....@e@e.....e@e@e@@e..e@.e@....e..
w....e..ee.....e.e.ee.e..eeee..@e@.w
...ee@e@@@e......e@..e@..e@@...e....
..e@.e.eee@.e.e...e..e@e.e@e.....e..
w.e.e@.....e@e@@e.@...@e.e..e@..e@.w
..@e@...e@e...@e..e...ee.@..@e.e@e..
...@e...e.....e.ee...e@@ee..@e.@e...
w....@e@@.e..e@e@@.....eee..e......w
..e@.e.eee@e@e...e.e@..@@@ee.ee.....
..@e@e@e@e......e.e.e..ee.e@e@@e....
w....@e..@e.e.e.@e@e@...@...@e..e..w
...e......e@@e@e@..@ee@ee...e..e@...
..e@.e..ee.e@e.@e@..@e@e@..e@@ee@...
w.@..@ee@@e.@e@e.e..e.e@e....e@@e..w
..e.@e@.@e..e@@e@e..@e@e@...........
....e.e@e@....e.@e.e@.......ee@@ee..
w.e@..e...e...@.e.e@eeee...e@@eee@.w
..@ee@@e@e@...ee@.@e.@@@.@e...@.....
..e@ee..e@......@e...eee@e....e.....
w.e@@@e...e...e@e..e.ee@....e@.....w
...eee@...@ee.....e@.@@e@ee..e......
..ee@@e@e@e@@e@e.e@e.ee..e@@e.e.....
w.@e@e.eeeeeee@@e..@e.@e.e@e..@....w
....e@.e@@@@e@ee@@e@e.....e@.ee..e..
.....e@e@ee@ee.@eeee@..@e@@e.@@.e@..
w.e..eee@ee@e@e..e@@ee.e.ee.eee.@e.w
..@e.@e.ee@e@e@..e@e@@..@e@.@@ee@e..
..ee@e.e@@e..ee@e.ee@e..ee..e@.e@...
w.@e..@e@....@.@ee@@ee...@e@ee..e..w
....e@eee...ee.e..e@e@..e@..e@e.....
..@e..e@...e@@....e.e@...ee..e@.....
w.e.e.e@e..@ee...e@..e..e@@..e@....w
....@ee@e...@e..........e@e...e@e...