33,36
360
360
1000
.....ee@.e@ee@e..e.e@e@e@@e@@e......
w.e..@@e..@eee@..@e.@ee.eeeee..ee..w
..@..e@ee.ee@@......e..eee@@...@@e..
..e.....@....e.@e.e@e.e@@@ee@e.e@...
w..e@...e.e....e@..e@.e.e.e.....e@.w
..e.e...e.@e.e........@ee.@e..e..e..
..@..e@e@.e@.@e......ee@@e@e..@ee...
w.e..e.......e@...e@e@@@e@.@ee@e@..w
.....@e...e..e.....e.@ee....e.e@....
..e@....e.@.e@....e.@e.@.@e.@e@e@...
w.ee..@e@.e@e.....@ee..e.ee.....e..w
..@@e.ee@e.@e....e...@e@e@@@ee@e@...
..e........e....e@.e@e..e.ee........
w...e.e...e@.....e..ee..@...e@@e...w
..e.@e@.e..e.....@@e@@..e@e..ee@....
..@@e...@ee@e.@e@ee..e..@@eeee......
w.ee@e@.e@.e@.e@..e..e.@ee.@@@...e.w
..@eeee.@e..@ee..e@.e@@e...eee...@..
....@@e..@..e@@ee@@ee@e@e....e@.ee..
w...e....e...e@.@ee...e@@e...@ee@e.w
..@e...e...e@ee...e..@ee@e.e@e@@e@..
..ee@e@@e...@e..e@@e@e..@e.@..e@e@..
w..@e.ee@...e.e@ee.e@e.ee..ee.@e.e.w
.......@e...e@e@@e@@@e.@e...@e.@.e..
....e@ee@@eeee.ee.eee..e@...@eee.@..
w...@e.@.ee@@@e@ee@.@e.e@e.ee.@..e.w
.....e.e.ee@e..e@@ee@e..e@e@..e.e...
..e..@e@e@@e.e@e.e@@ee@e..@e..e@@e..
w.@ee@.eee@e.......e@...ee@@...e...w
.....ee@@@@e@eee.....@e.@eee.e.e@e..
..@ee@@@eeee@e@@.....e@.....e@..e@..
w.eee.ee...e@e@e.e.ee........@ee...w
..e@@e...........@e@@e@e..e@ee@@e...