33,36
359
359
1000
....e@........eee@@e..@ee..e@e.e@...
w....e..e@e..e@@.eee@.e.@e.e@.e@e..w
....e@.ee...e@@ee@.@e..ee@..ee@..e..
...e@..@@e.e@.e.@.ee..e@.....e@e@@..
w...@eee.e.e@...e.@....e@eee@ee.ee.w
....e.@e.@..e...e.e.e@.e@@@e..@ee@..
...e@.e@.e..e..e@...ee@@ee.....ee@..
w..e@e@....e@......e@.e@.ee...e@@e.w
..@e.@eee@e@@ee@e..e@e@e.@@e@e...e..
..e...e@@ee@e..e@.e@.e@e.e@e@.e@.@..
w.@...e@e.ee........e@@e.e@ee..eee.w
..e@..e@..@@@e...@e@.@e@..@e....@e..
...e...e..eee..e@e.e@e...eee@.......
w....e@e.....eee@e@e...e@@e.e.e....w
.......@e...e@@ee@..@e..e.e..e@..e..
..e@.e@e@e.e@.e.@e@.e.....@e@@@ee@..
w.eee@@e.@e..e@@e.ee@e...e.@eee....w
..@e..e@...e.e@e..e@.....@e@e.e..e..
..e........@.e.....@ee@e.@e@ee@.e@..
w.@e@...@e.ee@.e@e.e@@@e.e.@e@ee...w
..e@e...e@e.e@e@.....eee..@e.e@@.e..
...e....e.e@ee@e@e@ee..@e.e@e@.e.@..
w..@....@e.e@...e...@..e@....e...e.w
..eee.....e@ee@.....e...e....@e.....
..@e@ee..ee@@ee.....e...@.....@e.e..
w.e@e@@e.@@e@e......@...e..e.....@.w
..e...e..e.ee..e@e@ee.e@@e.@e....e..
..@e..@e..e@@e.e@@e@..@e.e.e@.e@ee..
w.....e@@e@e@@.ee.e@e.e@.@e...@e.@.w
..e.eee.e...ee.@..e@e.@e.......@ee..
..@e@@@e@.e....e....e@.e..e....e@e..
w.@e@ee@@e@ee@e....@eee@@e@@e@ee@@.w
..e..e@.e.e@e@e....e@.e@e..e@...ee..