33,36
359
359
1000
..@e..........@eee.....e@@eee@e.e@..
w.e..e.....@e@e@@@@e@.eeeee@..e..e.w
..ee.@e....e@ee@eee@ee@@e...e@@e....
..@@..e@e.ee@@e......e@...e.ee@e....
w.ee....ee@@e@ee@.....e..e@.@e...e.w
..e...e@@e...e@@e....e...e@ee@...@..
..@e@e.e.@e@..ee@eee@@e.eee@@..@ee..
w.@e@e.@e.@e.e@@e@@.e@..@@..e..e...w
..e@..e@e.......e@e.ee@.ee...@e.....
...e@e.....e@e...ee@@ee....e@ee@ee..
w.e...e@eeee@@e@.@@e@...@e@e@@@e.@.w
..@...@.@@@ee@ee.e..e...e...ee@e.e..
..ee..e.ee.......e....e...ee@.......
w..@.e@.@e..e@e.e@.@e.@e.e@e..e....w
...ee@@e....@@ee@@ee....e@@e@e@.....
...ee@ee@.e@ee.@ee.@e....@e.....@e..
w.e@.e@.e..e.e@e...e.....e..e@.@e..w
....@e.....@e@.@..ee....e@ee.e@e....
..e.ee....e.@..e.e@@.e..ee@@ee@@.e..
w.@..@....@ee.@e.e.e.@e.@@e..@ee.@.w
..ee@e......e@e@e@..e...ee@@e....e..
......ee@.e...e@e@..@e@e@@@e....e@..
w.e.ee@.e@@....@ee..e.e..eeee..@e@.w
..@.@@...ee...eee@....e.e.e@@e@e.e..
..eeee.e.e@..e@.......@.@@e.e@e.e@..
w.e@@@.@e..e@.........e.ee..e@@e.e.w
....eee@e...e........e@....eeee@e@..
..e..ee@..e@.....@e...ee.e.@@e@.e@..
w.@e@@@e@e@e.@e..e.e.e@@e@.e@ee..e.w
..eeee.e@e@@eee.e.e@...e@@e..@@e.e..
..@@e@...@ee..@e@.e@.....e.e@ee@.@..
w.ee.ee.e.e@.e@e..ee.......e.e@..e.w
..@ee@@e@.e@e....e@@e.....e@........