33,36
351
351
1000
...e..e@e@e.@ee..e@@e@ee.e@...e@@e..
w.e@..@e....e@@e.@ee..e@@ee...eee..w
..@.......e..e@.e.....e@e...e@@@ee..
..e....e..@e..e.@e......e@e.@ee@e@..
w..e...@@e@@ee@e.@e...e@e@e..@.e@..w
..e@@e@ee.e@e@e@@e..e..ee@e..e.@e...
...@ee....@...e@eeee@.@ee@..e..e@...
w..e@@eee@e.....@@@e..e.@e..@e.@@e.w
.....e@@e...e@e.eee.......@e@eeee...
..e..@e@e....e@ee@@e..e...e.e@@@e@..
w.@@e...@@e@e@.e@e@e@e@...e@e@ee.e.w
..ee..e@ee@....e@eee@ee.e@@e@.@e....
................e@@e.e@..e@e........
w.e@.....e......e@ee@@@e.e.@.......w
..@e.e..e@@e...e@@e.eee.e@eee@e.....
..e..@e@e@e...e@.e@ee@@.@e@..ee@....
w.@ee@e@e.....@e..@e..e.ee...@.e...w
..e@.@e@e@ee@e@e..e.....e@...e......
.....e@@e..@e.e@.....e..e@eee.......
w.e.e..e..e@@e.e@....@.e@ee@@e@e...w
..@e@......ee@e.e...ee.@e....ee@@e..
..e@@e....e@e@@e....@ee@e..e@@@@e...
w..@ee....e@@e@e......@@e...eeee...w
...ee@e@e@@e.....e....ee............
..e.e@.eee.@e@e.e@eee@.@.@e@.....e..
w.@e@ee@@@e..e@e@e@@ee.e@e.ee...e@.w
..@e.@e@e@e.ee@@e....eee....@....e..
..ee@e..e@e.@.e......@@@e@e.e....@..
w...........e..e.e@e.ee...e@e....e.w
...@e...@eeeee@@.e@@e.e...e@ee......
..ee..@ee@@@@.ee..ee@.@e.....@e.....
w.@e..e.e.eee.....ee.e@ee@e.e@@e...w
........@e.......e@@e@e.@e..@e......