33,36
350
350
1000
..@eee........e.@e........@e@ee@ee..
w.ee@@e.......@ee@.ee@@e..e.ee@..@.w
...@....@e.e....@e.@.ee@e@.e@eee.e..
...ee.@eeee@..e....e.e@..e.e.@@@e...
w.e@@.e.e@....@e...@..e.e@.@.ee.e..w
..@ee.....ee.e@@..eee@@e@..e.@e.@e..
.........e@@eeee@.@e@e.e@e@e....e@..
w..e@e...@e@e@@ee..e.....e..ee.e@..w
....@e@..e.@e.e@...@e@...@ee@@e.....
....e.e....e.......e.e....e..e@ee...
w...@e.e.@e@....ee@@....e.@.e@e@@e.w
....@e.@.e......@@ee....@ee.@@e.....
....e@.e..e@..@ee.e...ee@e..ee......
w..ee@e....e.@e@..@e@e@e@e...e@e...w
...@@e....e..e...e@e..e@e@e.e@@ee...
...ee.....@e..e..e@@e@@..e@.@.e.@e..
w.ee@....e@eee@...e..eee@e@.ee@.e@.w
..@@e.e.ee@e@@e...e....e@.e..@@e....
..e..e@.@...ee@..e@....@e..e@ee.e...
w.@..e@ee@e.@@...e@.....e@e.e...@..w
..e....@e@..ee...ee...e.....@eeee...
..e@...e@e@e.ee..@.ee.@e.....e@@ee..
w.@e...@e.e.e@@e@e@@@e@..e@.e@@e@@.w
...@e.e@@.@e.e.e@.ee..e...ee@@ee.e..
...@e.@ee@...@e@ee..e..e.e@@@ee@e@..
w.ee@...@e....e@e@e.@..@.eeee.@ee..w
..@e.....e..e@ee@e@.e@@ee@@e@ee@@...
..e@....e@..@e@.@e..@eee.e@e@@e.e...
w..e....e@....eee@e@@e.@.@e.e....e.w
..e@....@e@@e.@@e..ee@.ee@e..e.e.@..
.........eee.@e.ee@e@......e@@.@ee..
w.e...ee.@.@ee@.@ee@....@e..eeee@..w
..@e.e@@ee.......e@e....e..e@.@e@e..