33,36
358
358
1000
...e@@e..e@e@@ee....e@e..e@ee...e@..
w.eeee...eeeeee@@e@........e@....e.w
..@@@e..e@@@.e..e.ee@ee.e..@........
..ee.@e@e@ee.@ee@.@.ee@.@e@e.e@ee...
w.e.eeee.@e@e@@.e@ee@@@ee@@e.e@e@..w
..@e@@@e@e@..ee.e@.@eee.@eeee.......
..e@@ee@e....e.e@e.e@.....e@@e...e..
w...e..e@@e@e@.e@e.......e..e@..e@.w
.........e@.e.e@....@e...@ee@e@e....
..@e....e@.e@e.@e..@ee.@e@e@...e.e..
w.eee......e@@ee@..e.@.e.e.....@e@.w
..e@@e...e@.e..@e....e@..@ee..e@e@..
..e@e.....e@e.e.......e@e..@e.e@@e..
w.e@e......eee@@e..ee@e.@......ee..w
..e@e@e..ee@@..e..e@e@..e.ee@e.@@e..
...e@....@@ee...@e@e.ee@e.@@e..e....
w.e......ee@...eee.@e.....ee@......w
..@e@..e.ee....@.@e@e.@e..@e.ee..e..
..e@eee@e@@e...ee@ee@.e..e..e@@..@..
w..@e@@.@@ee@.....e@@e@e.@e...e.ee.w
...e.@e.ee@.e.......e..@e@e....e@@..
..e..e..e......e......e@@e......ee..
w.@e....@.e@e.e@e@..ee.e..ee....@@.w
...@@e..e.e....e@e.e@@@e.e@@....ee..
...ee.e@@e@.....e@e@eee..e@e...e@...
w..e..@e.e@@eee.....@e@..e@.e@e..e.w
..e@e@.e.eee@@@.....e@e@e.ee....e@..
..@.ee.@e@.@eee@e.....ee@..@e..@ee..
w.ee@e.e@.e.e@ee@ee.e.@...e.@e.e.@.w
...@e@.@..@e@...e@@e@ee..e@.@e@e@e..
.....@eee@ee@@e..e@.e@e....@e..e@e..
w...@e@@e...ee..e.ee@.@....e.e.@e..w
....e...........@e@...e...e@e@......