33,36
356
356
1000
....e....e.e@.e@eee@.........e@.e@..
w...@e..e@.ee...e@@ee..e.e@e@eee.e.w
......e.e..@......e@@ee@@e...@.@e...
..@e@e@.@e@ee..e@.e@....e.e@eee@ee..
w.eeee..@ee@@e..e..e..e@@.@..e@ee@.w
..e@@@e.e.e...e@..@e..eee.ee@@.ee@..
..@eee@eee@...@ee.e.e@@@@...ee.@ee..
w.@e@..@@e...e..@e...eeeee...e.....w
..ee@..e@.@e.@e...e@e....@e@e@......
....e...e.ee@.@....ee...@eee@.......
w.@e.......@e@e...e@@e.eee@@@e.....w
..e@..e....ee..ee@e.@e.@..@ee@@e.e..
......@@ee@@@ee@.e@ee..e@.e.e@e.e@..
w...e.ee@.eee@.....@e...e....e..@e.w
...e@e@@.e..@.e.....@e.e@....@eee...
...@@e@e.@..ee@.....e@.....ee@e@@e..
w..ee@.e@e@e@...e..e@e....e@@.e@e..w
......e@e.ee@ee.@..@@ee@@e@@ee......
....e@@ee.ee.e@.e..ee@eee@.e.@e.e...
w.e@eee@@e@@ee@@e..e.e@@e...e@.e@e.w
..@e....e@e@@eeee..@ee@e.....e.@e...
..@e...@e..e..@e@......e......e@e...
w.e....e.......@e......@......e@.e.w
..@e@e.............e...e.@e.e..e@@..
...e@e....e@e@e....@e..e.e@.@e@eee..
w.ee@e....@.........@e.@..ee.@e....w
..@e@e..@ee@e....e.e@@ee@e@@........
..@e@e..e.@.@e...@.ee.e@e..e@eee....
w.e.e@....e....eee@@ee@..e.eee@@...w
..e.@e@@e.@....@@@e@e@@e.@e@@e@e@e..
..@.e.eee@e@.e@ee..eeee..e@@e@.e@...
w.ee@......eee@e..e@@@e.e@.e.@e.e..w
........e@e@@ee@e@e.e.@e@....e.e@e..