33,36
364
364
1000
.....ee@.e@e@@e..e@............e@e..
w...e@ee..e.ee@e..e.e@e.....ee.@e..w
...e@@e......e.@e...@ee@e..e@@e..e..
..e..e...e@..@e@@e...e@e...e@e.ee@..
w.@.e@....e..eee..ee.@.@e..e@..@e@.w
..e.e@..eee.e@@..e@@eee@.e..e.e..e..
..e@@e..@@@e@@e........ee@e...@ee...
w..e....ee@e.e.......e..@...e@e@@e.w
.....e@ee..@e.e.ee..e@..e.....e@e...
...e.e@.@e@e..@e@@e.e@ee..e...e@@e..
w..@..e....e.e@e@@e.e.@@e@@e...e.e.w
...e..ee..e@.@e.ee.e@@e..e.@e.e..@..
.....e@@e@..e..e@e@e@e.e.@e@@e@..e..
w..e..ee.e..@ee...e@..e@@e.ee@@ee..w
..e@..@....e..@e@ee.e@e@ee....e@@e..
...@e.e@e.e@@e..@e@..ee..@e...@e....
w..ee@.e@..@ee..e..e@.@e@e....@e@e.w
.....e.e.e@ee@e....@e..e@e.e@ee.....
...e@..@e...e@@e....e..@e@e@@e...e..
w..@eee@@.@e.e.e..e@@e@e..e@e.e@e@.w
...ee@.ee@e.e.e@e..e@@...e@e....@e..
..e@@e.e@..e@e@e@e@eee@e@@e.........
w.e@e@.e@e.....ee....e@ee@@e.@e@e..w
..ee...@eee@e.e@@eee.ee..e@eee@e@...
..@e...@e@@e..e@..@@e@@@ee@e@..e....
w.ee..@ee.....@e..ee@@ee.e@...e@...w
..@@e.e@@@e....@...e@e.@e@e...e@e...
..e...e@ee...e@e......e......@e@@...
w...e@ee@.....@e....ee@...e..e@ee..w
....@@e@@ee@e.e.e...@e@...@e..e@....
....ee..e..e@...@.eee.e..ee.e.......
w.e@..e@ee@@e@e.ee@@ee@e@@@e@.e..e.w
..@e.e@e..ee......e@e@..ee....@ee@..