33,36
360
360
1000
..@e.e@..@e..e@@e.ee@..ee..e@e...e..
w.e...ee@e...@eeee@.e@e@@e.@ee...@.w
..e..e.......@e.@@e..e@@ee@e.@e..e..
..@ee@.......ee.e.....ee.e@e@e......
w.@e@...e@e.e.@e.ee..e@..@e..ee....w
..ee@ee.e@@e@.e..@@e.e....@ee@@.e...
..@ee@@eee.e.e@..ee@.@e.e.....e.@...
w.e..e@@@..@.e...e.e.e@.@e.@e...ee.w
..@e@eeee..ee@e@e@e@@e@e...e@e@ee@..
...@e.@.....@e@.e@..ee@....e@@...e..
w.e@@.e..e.e.e...e....e.@e..ee.@e@.w
...ee.e@e@.@e@.e.....e.@e..@e..e....
...@e...@e.e@.e@@e..e@ee...e@e..@e..
w..e@..ee@e@eee@e..e..@e...e@@..e..w
.......@@.e@@@e....@ee@e...@ee.e@...
..e....ee@@ee@@..e@ee@@e.e.....e....
w.@.e..@.ee..ee.....e@e@e@e....@e..w
..e.@..e.e@@e...ee.e@...@e@...e@ee..
....ee@e..@e@e@e@@e...ee.e@e....e@..
w.e@ee@...ee.@e...e@ee@@ee@e@ee..e.w
...e..ee@ee@e..........@e@@e.e@.e@..
..e@e@@.@e.e@..e....e..eeee@........
w.e..ee@e..@e..@e..e@.e@@@e.e..e...w
..@.....@ee@e.e@@e...e@ee@@.@ee@....
..ee@eeee@....@e.@e..@e.@ee....e....
w.....@@e@ee...e@ee...@e@e.....@e..w
......e@...@e@e.e@@e@e..e.e...e@ee..
..e....e...e.....e@e.ee@@.@e..e@e@..
w.@e.e.@e..@@ee@e@.@e@.eee@e..e@e..w
...@e@.....ee.@...e@e..ee@@e..e@e...
...e@.....e@e@e...e@e.e@.@e@...e@...
w......e..@e@.e@e.@e.e@@eee@ee.@e..w
.......@ee@e.......@e..e.e@.e@e@e...