33,36
360
360
1000
....@e..e@e....@ee@e...e@e.ee@e..e..
w..ee...@......e@e@e...e@..@e@e..@.w
...@e...e.....ee@...ee..e....e@.ee..
...@e.e@@e....@@e..e@@e.......ee@@..
w..e@..e@e...@e...ee@e.......e@e.e.w
..e@e@...@e..e@...@e@ee@ee@ee..@.@..
.....e.ee@ee@e.....e.ee.@@e@@e@e.e..
w..e...@@@e....e@ee@e@@ee....e@e@e.w
...@e..eee@e@eee@@e..e@ee@e.....e@..
.........e....@ee..@e@e.........e...
w........@e@ee...e@e..@e.@e.....@e.w
.....e.......@e..@e....@.e@e........
.....@e.e....e..e@.@e@ee............
w..e@e.e@@ee@@.e.e.e@e@@e@...e@@e..w
...e@.e@.e..ee@@e..e.e@@eee@e.eeee..
..e@e.....e@..e@e..@e.eee...@e.e@@..
w.@e.......ee@e..e@.....@ee..e@e@e.w
..e...@ee..@e@@e..ee@...ee@.ee@e....
..@ee.e.@e.@ee...ee.ee@.@@ee@e@e@e..
w.ee@.e@..@e.ee@e@@e.@e.e..@.@@ee@.w
..@eee.e..e.e@@e.@e@@ee...@e.ee.....
..@e@@e.e......@ee..e.@...e@........
w.e@@e.e@..e@e@.....e.e...@..@e....w
....e...@e...@e.@ee.@e.e@eeeeeee@...
....e...e...e@@.e@@@ee...e@@@e@.e...
w..e@...e....ee...eee@@e.e.ee..e@e.w
..ee@.e@@e.e@e.e@e..e@ee.@e.@e.@....
..@ee..e@ee@@e@..@e@e..@..@ee@.ee...
w..@@ee@e@..e@ee@...e@ee.e@@e@e.@e.w
..ee.e@..e.e@e..ee@e..@e.@e@e.@ee@..
..@@.e@..@..e@e@e.e...e@........@e..
w.ee.eee@e.e@e@...@e.e@e.e@ee@e.e..w
..e@e@@e.@e@......e@..e@...e@e.e@e..