33,36
378
378
1000
...@e@e....e..e@e..e...e@ee.....e...
w..ee@ee..e@e.e.ee@@e....e@ee..e@e.w
..e@@e@@ee@e.e@e@.e@e..e@.e@@ee@e@..
..ee@e.e.e@@@e.@@ee@e..@e..e..e@e...
w.@ee@e@e.eee@@ee.e@@.....e@..@e...w
.....e@e......e@..eee....ee@ee@.....
...ee@.e@...e..e@e@@e...e@@e@@e@e@..
w..@e...ee.e@e@.e....e..@eee@e...e.w
..e@@e.e@@...ee.ee@@e@@e..@.@e......
..@e...e@e..e@ee@.ee.ee...e.e@......
w....ee.@e.e@@e@..@e....e@e.....e..w
...ee@@.ee...e@ee..e@ee..e@..eee@...
...@e@e.e@.e@ee@@e...e@.e@..e@@e....
w.ee.....e...ee@e@..ee@..e@@e@@e@..w
..@e@@ee.@e.e@e@.e@.@@e...ee.ee.e...
..e.eee@.@e....e@.e.e..e@e.e.e.e....
w.@e.....e@.@e..e.e.e@ee@ee@e@.@ee.w
..ee......e.e@...e@....@e.@e@e@ee@..
..@@e...ee@@e@...@......e.e..ee.....
w.e@@@e.@e@e.e.e.e..eee@@....@@e...w
...eee.e@@e....@...e@@.ee...@e......
..e...e@e@.....e..e@@e@e.e@eee@eee..
w.@e.e@e.e.........eee@@e@.e@.e@@@.w
..@e.@@e...e.e..ee.@eee...e@@ee@ee..
..e..ee.eee@.@e.@@e.e@@.....ee@.ee..
w....e@e@@@ee@e.e...e.e.....e@@e@@.w
..e...ee@e@@e@......@@e...e...e.ee..
..@@e@@e@ee..e.e@e..eee@ee@e@e.e@e..
w.ee.ee...@....@e.........e@e....@.w
..@e..@e..ee...e@.........e@@e.e@e..
..@ee....@e@ee@e..e@e.....@e@e......
w.ee@e.eee..@e.....e@.e....e.e@e.e.w
....e@e@@e...e@e...e@e@....@ee@ee@..