33,36
360
360
1000
.....eee@e.e@@ee.@ee@.e@e@e....e.e..
w...e@@e@e@@eee@.e@.e.e@ee@e..e@e@.w
....e@e...e..e@....e..e@.e@@e@@.....
..ee.e@e...@e......@e..e.eee.ee.....
w.@@.e@@.e@e.e......e@ee@@@@..e....w
..ee.eee....e@@e.......@eeee.e@e....
...@e@..@eeee@e.......e@.....@e@@e..
w.@ee@e@ee@@ee@........e.....@e.e@.w
..e..e..e@e@e...e............e...e..
..e..@e.eee@@e.e@...e@ee...e.@e.e@..
w.@ee.@.@@.e@e@e..e.e@.@ee.@e@..@e.w
..@e@ee.ee..ee@@e.@e.e..@@.@ee..e...
..e.e@.e@@e..@e.@e...e@.eeee@ee@....
w.e@ee@ee@..e@...e...eee.e@e@@ee@..w
....e@e.ee..@e...@e..@e@.e.@e@..ee..
...ee@@e@e@e......e@e@e.e@e.ee..@@..
w..@eee..@e.@e....@e@.@.@e..@e..ee.w
.....@e.....ee@e@...e@e.............
..e@e@e.....e...e.e@@e....ee..e.....
w.ee@@e@e..e@ee..e.e@e@e..@@ee@....w
..@@eee@@e.@ee@..@@e@@e@..ee@@e.e...
..e@e@.ee@e@e@...ee.e......e@@ee@e..
w.e@@@e.e.......e.....e@eee@eee@e..w
...eee..@ee..e.e@....@e@@@@..@.e@...
..@e@@@e.e@..@e@.....e@eeee..e.@e...
w.e..ee@...e@@e@..e.e@e...e.....e@.w
.....@......ee.e..@..e@...@@e...@e..
..ee.e...e......@ee..@....ee........
w.@@....e@..e...e@...ee....e.ee.@e.w
..ee....ee@e@.ee@e@...@e.ee@e@@ee@..
...e@@e.@ee@@e@@@ee....e@@....@e....
w...eeeee@..e@@eee@.ee..ee....e@...w
.....e@@e@e...e.e@.e@@e...e@e..e@e..