33,36
363
363
1000
...e@@e.@ee.....e@e.e..e@...e@e@ee..
w.@eee.@e@@e@...e@..@..@e.ee.e..e@.w
..e.ee.e.e@ee....e..e.e...@@e@..ee..
...e@@.@e.e@..........@ee.e....e@@..
w..@ee.e@.@@e@ee@e@ee.e@@e.......e.w
...e....@eeee.e...e@@eee@ee@e@@e.@..
..e@..e.eee@@.@e..e@e@@@ee@@eeee@e..
w....e@.e@e.e......e..ee@..e@.e..e.w
.....e@e@.....e....e@e........@ee@..
....eee@e.e..e@.@e.e@@ee@ee@.....e..
w.e@@@@@e@@e....e@e.e@e..@ee...@e@.w
..eeeeee@e...ee...@.e..........e@...
..@e..@e@e@ee@@ee@e.@.....e.ee.@e...
w.@e@@e.@e@e.e.e@@e@e....e@e@@.ee..w
..eeee@@e...e@..@e..@e...e@e@e.@@e..
..e@..@ee...e...e.....@e...e@e.e....
w..e..e.@..e@e@e.....ee........e.e.w
...@....e..@e.e@.....@@.e.....e@e@..
...e..e@e..e..e@e....eee@.eee@e@@e..
w.@e.e@...e@e.e@e....@@@ee@@@eee...w
..e...e..e@e..e@.e@e@ee.@e.e.e@ee...
..ee@e@e.@e....e.e@e.e.e.....e@@@...
w.@@e.e@@ee...e..@@e.@e@.e..e.eee..w
..e.....e@@e@e@..ee.e...e@@e@.......
..e@e@.eeee@.e@e....@.@e@.e.........
w..@ee.@@@e..e@e...ee.e..e@...e@.e.w
...e@e@ee@...@ee@e.@e@e....e@eee@@..
...e@@e.@e....@@@e.e.@e.e@.@e.@@ee..
w...e....@e@e@eee@e..e...e..@ee....w
..e..e....e@e@....@..ee@e@.e@ee.....
..@.e@@e...@ee@e..e..@e@...e..@.....
w.eee@e.@e@e.ee...@e...e@ee@.ee....w
..e@@e..e...e@@e.e@ee@e.....e@......