33,36
359
359
1000
........e@e...e@.....e@e@@e@@e.@e@..
w.e..@e...@@e.ee......e.ee.ee@.e.e.w
..@.eee@e.ee@e@@..e@e.@..e@@@e@.e...
..ee@@.......e@e..@e.ee...eee.e.@e..
w...@e@e....@e@.e....@e.e.@eee.....w
...eee......e.e.@...e@e.@ee@@@e@e...
..e@.@e...e.....e..ee@....e@e@@e....
w.@e.ee@e.@e...e@e@@@e..e..eeee..e.w
..@e.@e@e.eee@e..@ee@@ee@ee@@@@e.@..
..e@..ee@e@@e.@@e.e.e@e@....ee...e..
w....e@@ee@@e.ee@.@..@e@e...@....@.w
...ee@e.e@ee@..e..ee.e..e..ee...ee..
..e@@e.e@@e....@...@ee.e@e@@@..e@...
w.@.e@.e@e@...ee@..e@@e...eee@ee@e.w
..e.e........e@.e@.ee@...e..@e@..e..
..@e@.......@ee..e.@eee.e@@ee...e@..
w.e@.....e..ee@......e@...ee@...@..w
..e@e@e.e@.e@e@....e@@@e.e.e@ee.e@..
......e@e..@e@e.e...eee@e@.@e@@e.e..
w.@e.e@@e..e....@ee@@e..........e..w
..e....e@.@e.e..e.@e....e.....e@@...
...e@e@ee.eee@ee@......e@.eee.@ee...
w..@e.e@@e.@e@@@..e@.e@@e.@@@e@.ee.w
..e@...ee....eee...e..e...ee@.ee@@..
...e...@@e@......e.e.....@e.e..e.e..
w.e....ee@e...e..@e@e....ee@.e.@e@.w
..@ee...e@...e@.e@e@@e.....e.@ee....
..e@@.e@ee.e.....@ee@e@ee.@e........
w..@e.@ee@e@.@e..ee@e.e@@.e........w
...ee@e@@e...e....@@e.@@e.@e...e.e..
...e@..e@e.....e@eee..ee.....e@@e@..
w..@...e@ee@ee.@@ee@e@e..e.e..eee..w
...e...e@e@ee@.ee@@e....e@.@e..e@...