33,36
367
367
1000
..e@@e.....e@..e..e@ee@@ee@e.ee.....
w..ee......@e.e@..e@e.ee.@e.e@@e...w
..e@@e.e@e.e@.@e......@@..@e..e@e...
...e@.ee@ee@...e@e.e..ee.e@@e.@.@...
w..@ee@@@e..@e.....@..ee@ee...e.e..w
..e@@@eee...e....e.e..@@e@.ee...e@..
..@ee..e@...e@..e@..@ee.e.e@@e...e..
w..e@......e.ee@e@e.e...@e.e@@ee@e.w
..ee@@e.e@e@..@e@...e.......ee......
..@.ee...e@...e.....@ee......@.@e@..
w.e...@ee..e.e@..e@...@e....ee.e.e.w
..e.eee.@e.@ee.e@eee....@e.e@e...@..
..@e@@ee..e@e@.e@e@@e...e..@...@ee..
w.@ee@e@..ee..e@e.e@eeee@e.ee..e...w
..e.@eeee@@e.ee@@e.ee@@@e...@e...e..
..@e..@@ee@e.@.e.@e@e@e....e...e@@..
w.@e..e@e....e@@.e@.e@@e..e@e..eee.w
..e.e..e@.e@e.ee@e...ee@....@ee@....
...e@......e@.e@eeee@e.....e@e......
w..e@ee@...@e@ee@@@e.e@......@..e..w
..e@e.@e....e.e@.eee@ee...e..e..@...
....@..@.ee.@ee@ee@@..@e.e@e@...ee..
w.e@e..e@@@e@ee@@e.e....@e@eee@ee@.w
..e@...@eee@e..e@e...e..e@.@e..e@e..
..ee@ee@@e..@e......e@e.e@.....e....
w.@...@e@e..@e...e@ee@@e@eee@e@@@e.w
..e......@e.ee...e@@@e..e@@@@eeee@..
.....ee@e....@e.e.eee....@eee.@e@...
w..e.@e@e@...@ee@..@@.e@@e..e@e.@e.w
...@.e...e.e@e...e@ee..ee@..e@e@e...
...e.e@..@e@.....e........e.e@e.....
w.e@..e@ee...e@e.@e@eee...@@e......w
....e@e.....e@e..ee@e@@e..ee........