33,36
358
358
1000
..e@.ee@e.e@@e.....e@ee@e@...e@.....
w..e.@.ee@@ee........@.e.e....e....w
..@e.ee@@e..@...ee@..eee.@e...e.....
..e....e@ee.e...@ee..@@@@e.e@.@.e...
w.e@e@e@e.@e..e...@..eeeee@@e@e.@..w
..@@e.e@@e@e.e@@e.e..e@..@e...@@e...
..eee..ee..@.@@e...e..e@e..@e.ee....
w.e@@.e@@.ee.ee....@e......e.e@@e..w
...ee@@@ee@....e.ee@ee.e..e..ee.....
..e@@eee@......@e@@ee@e@..@e@@@e@e..
w....e@..@e....e@e@e..@e..e.ee@e...w
...ee@.eee..e@.......e@e...e@e@e@e..
...@@ee@@e...e.ee..e.@e..e@@e.e@e...
w.ee..e@......e@@e.@e....@e.@e@.@e.w
..@e.e.e.eee@ee@@ee@e.e@....e.@ee@..
..e@e@...@@..e.ee@..@e.e......e@....
w.e@...e@eee@@e.ee.e.eee..e@ee@e...w
...e...@..@ee@e.@@e@e@@@e..e.@......
...e@e.ee@..@e..ee@ee@e@...@ee......
w.e....@.ee.....e.e@@e.e@@eee..@e..w
..@e...e.e@.....@...e@.@ee@@@e.ee...
..e@..e@e.e@e...e...@ee@e@.e@e..@...
w...e@@.e..e@@e@e@ee@...e......@e..w
.....ee@@ee@ee..e@..e@ee@@ee@e@e....
......@e@.e@@.e.@e..@e.e@e....e@....
w....e@.e..eee@..e@eee@e@ee@..@..e.w
...@e.e...e..e@e...e@e@@ee.eeee.e@..
...ee@@eee@.......e@e.e@e@..@@e.e@..
w....e..@ee..e@ee@ee@.......e@e..e.w
..@e.@e.e@@e....@ee@..........ee....
..e@.e..e@e....e@e..e@e...e@e.@@ee..
w....@e@e......e@@e.e@e@e...eee..@.w
.....e@.........e@e........e@@e..e..