33,36
353
353
1000
..e@e.e@e..ee..@e@e..e@.e@e.@e......
w.....e....@@.ee..e@..e.e@e.e..e...w
..e@@e@....eee@e@.ee@..e@.@e@..@....
...ee...@ee@.@e@ee@@e.....e...@ee...
w.e@....ee..@e.e@ee@@e..@e.e@ee.@..w
..@..ee@.@e@e..e@@@eeee.e...e@..e@..
..e..@.e.eee....eeee@@@e@@e@@e...e..
w.@e.e....@@ee@e@.@..e...e@ee@@e...w
....e..ee.e...@e@.e@e......@..e@....
...e@.e@@.e@e.e.e@e.e...e@ee.e@.....
w..ee.e@e..@e.e@.e@e@.e@e@ee@@e@ee.w
..e@@e.@e..e.e@e.@ee@e.e@e@@ee...@..
..e@e..e@e....e......e....e@e@e..e..
w.e@e@e@e@...e@ee@e.e@......e@@e...w
..e@.....@e..e@@.....e..ee...e@@e...
..@e@e..ee@...eee@...@e.@@...@e.e...
w.@e.@..@@......ee...e..eeee..@e@..w
..e..e..ee@e...e@@e..@...e@@........
..e@.@.e..e.e.....e@.e.ee@ee........
w.ee.e@@ee@.@.....@e@@e@@e...e.....w
..@e@ee..@@ee...e.@eee@@e....@e@ee..
..@e.@...ee.eee.@ee..e@e.ee@ee@.@@..
w.e..e@e...e@@@e...e.ee@e@..e@..ee.w
....e@e......e@ee@e@e@e.......e@e...
....@e@e@e..e@@e@.e@@.@e.e@e..@.....
w..ee.e@......e@...ee.......e.e@e..w
..e@...e..e.@e.e@..@.@e....e@.......
..@@ee@@.e@.e...e.ee.e@.e@.e@e..@e..
w.ee..eee.ee@..e.e@...e@@e.@e.eee@.w
........@e@..e.@e@e....e@@e@@e@@@e..
........ee@.e@ee.e@.....ee.ee..ee...
w..e@e..e.e.@e@.e@....e@ee..@ee.@e.w
....e@.e@e@............e@@e.e@@ee@..