33,36
348
348
1000
..@e.e@e@e..@e@@e.e@................
w.e..e@e.@e.e.ee...e....@e.........w
.....e@ee@e@e@.ee@e.@e.@ee.....e@e..
........e.@e.e.@@e..e..e.@e...@e@e..
w.e....e@e@ee..e@e..@@e...@e..e.e@.w
..@e@...@ee@@@e@.ee@ee.@e..e.e@ee@..
..e@e..ee@e.ee...@...e@e.e@@.@e@@e..
w.....e@@e@..@@e.e....e..@ee.......w
.....e@@e.@e.ee...e@.e@e@...........
.....e@e..e.......ee.e@@e.....@e.e..
w...eee@..@...eeee@..@e......ee..@.w
..@e@@e@e.e..e@@@@e......e@e@@e@.e..
..e...e.ee...e@ee.@..e@e..e@e@ee....
w.@.e@@.@@e@@e....e..@e.e@..e@e.@e.w
..e..ee.ee.eee.....e@e..@e..e.e@e...
............e@e@e....e@e....@ee@e...
w..ee@.e@.....@e.....ee.......e@@e.w
..e@@e..e.e..e@@ee@ee@@ee@e.e@ee@e..
...e@e.e@.@ee.e@@ee@e@e.e@e.e@@e@e..
w.e@...@ee@@@..e.e@e@@e@@e..@eee@e.w
.....ee@e@eee.......@eee@e...e@e@e..
....e@@@e.e@........ee@...@e.@e@e@..
w.....ee@e.e@e@e..........e.e@.....w
...ee@@.e@..e@e@.e........@e.e.e@e..
...@eeee@@e......@....e@ee.@e..@@e..
w....ee@ee....e@.e@e@e@@e@.....ee..w
..e.e@@@e@e@e.@e....e..e@...........
..@ee@ee.ee@ee.e...@e..e@e.e...e@e..
w.@e..e@e@e@e@.@e@eeee@e@e@@.e@ee@.w
..e...e..e.e@...@.e@@...e@ee..e@@e..
..e..e@.e@e@@e..e.e@e@.e@@e@..@.e...
w.@e.e@e@...e.....@@ee@..e....e....w
..e..e@e...e@.....ee.@e..@e.........