33,36
347
347
1000
...@e@@ee....e@.e@...e@e.e....e@e...
w..e.eee@.e@e.ee@ee@.e@.e@e@e@.e@..w
....e.......@e.@e.ee..e.@.ee@e.@.e..
...e@..e@.ee.e....@@ee@.ee@....e.@..
w..e....ee@@e@.@e.e@e.....e.....@e.w
...@e.e..@ee@..e..ee@..e..@....ee...
.....e@...e@.e@e@e@@e@.@e.e....@e...
w..e@e@....e@e.@ee@e.ee@@e@e@.e@@e.w
...ee@e@ee..e@e@.e@....e@@e.e..e@...
...@@e.e.@ee...e..e..e@ee@e....@e...
w..e@..@.@e@...ee.e.e@e..@e.....e@.w
...@e..e.e....e@@e@e@....e.e@@e..e..
..e..e..e......e@e@......e..ee......
w.@e.@@e@e..e@.e@ee.e....@e@e.e@...w
..e@.ee.e@...ee@ee@.@e@ee@ee...e....
..e.e@.e.....ee@@@@e@...@@e@...@....
w.@ee@.@e...e@@eeee.e..@ee.....e...w
...@@e....e.......e.e..e@@e.........
...e.e@..e@@e.@e.e@.@.@e.e@......e..
w.e@.@ee@e@e..e...eee.e@@e.....e@@.w
...e@..@.@.@e....e@@@e@@e......@ee..
....ee@e.e......ee@e..ee..e.ee......
w...@e@..e@...e.@e.@ee@@ee@e@@e....w
..ee@ee..ee...@e@@ee@@e@e@@e@e......
..@..e@ee@@@e@e.e...@e.e@.ee@e......
w.e.e@ee@.eee@@.....e..............w
....e@@e@e@..eee@ee.@e...ee.....@e..
....@eee@@.@e@e...@e@e@.e@@e....e...
w..eee..ee.e@.@e..ee@@e.e@.e....@e.w
...@@@..@ee@@ee@@ee@e@e..e.@....e@..
...eee..ee@@e.e@e.@e.ee....ee@..e@..
w.e.@..e@..e.e@..ee@e@@e..@e.e..@e.w
..@ee..e@e......e@@e.e@e..e.........