33,36
353
353
1000
.....e.e@@e........e..e@e.......e...
w.ee@@@eee...e@..e.@e.@@e..@e@ee@..w
..@eeee@.ee@e.e.e@e@.eee@.ee.@e.....
..@ee@@@e@@e..e@e@.e.@e..e@@.e..@e..
w.ee..eeee.....e.e@@e..@ee@e....e@.w
...@e..e@@e......@ee...e@e@e...e@e..
........@ee@e.....@@e...e@.@.e@@@e..
w.e.eee.e.@....ee.e..@e@ee@e..eee..w
..@e@@@...ee@@e@@e.e@e@@e@....@e@...
..ee@ee.e...eee@.@e@...e...@ee@..e..
w..e@e..@e.e@@.e@e....ee@..e.eeee@.w
...e@eee@....e.....@ee@ee....@e@@e..
...@e@@@e@@e.e..e@eee@.@@e@@e.ee@e..
w.....e@.eee@@ee@.e@@e.e@@ee@.@e@..w
.......e@@e.ee@.........e@e.e...e...
.......@e.....@e@e...e@....e@.......
w.e@ee@ee@e...e..@.e.@e...e.e@...e.w
..e@e@e@@.@ee.@e.e.@@e..e@@e.e...@..
..@e@e.ee@..@e..e..ee..e.e....@e.e..
w..e@@e@.e.....e@e@..@e@...@e@e..e.w
....e....@....e@e.e..ee@ee.e..e.e@..
.........e...e@e@.....e@.@e.e@@.e@..
w.@e.@e..e..@ee.e......ee@e.@ee..e.w
..e@.ee.e@e.ee@e@.......e@e..@e@....
......@e.e@e@.e@...e@ee@e@e@e..e....
w........@.e@e@..e.e@.e..e...@e....w
..e@ee@e.e..e@..e@..ee@.....@e..e...
..@e...@...@e.......@@.e@...e...@...
w...@e.ee..e@.....e@ee.@e......ee@.w
....e.e@@e.e...e@ee@e....e@..e@@ee..
......e@e@.@.e.@e.e@@e.e@ee...e@e...
w....ee@e..ee@e@e@ee@.ee.e......@e.w
....e@e@e.e@...e.e@.ee@@e@e@e@ee@e..