33,36
349
349
1000
..@ee....e@.e@@ee@e.e@e.e@e....e.e..
w.e.@.@e.ee..ee@.e@..@e.e@@....@.@.w
..e.e.e.e@@e.@eee@...e@@eee....eee..
..@e@.e@e@e.e@e@@..ee@.e@.@ee@e@@e..
w.e@e..e...ee...e.e@@e.......e@@e..w
..ee@@e@..e@@e...............@ee....
..@e@e......@e@e....ee...e@@e...e@..
w......e..e.e@.e@@ee@@e..@eeee...e.w
..e..e.@ee@e@@e.ee..@e@.e@e@@@e.e@..
..@e@@e..e@e@e..@@e.ee@e..e@e@e.e@..
w...ee@......@e@e..e@e@e.........e.w
....@@e.e..............e@.e..e......
..@ee..e@e.........e...ee.@..@@e....
w.e...e@e@.e...e@ee@...@e@e..ee..e.w
..@@e.@e..e@...........e@....@e..@..
..ee@.....e@e@.e......e@e...e@e..e..
w..e@.@e....@ee@...e@..e@..@e@...e.w
....e.e....@e..e@e..e..@...e@e..e@..
.....e@.e@ee.e@e.@e...ee...e@@e.e@..
w....@e...@ee@.e@e@..e@.e@e.e....e.w
..ee@e@ee.e@@@e......@e@@e@..ee@....
..@e@e.@@e..ee...e@e.@ee.e@e.@eee@..
w..e@@.e.......ee.e@.e....e@.e@@@e.w
..e@eeeeee....e@@e@e@e.e@e@@e@@e....
..@@ee@@@@eee@e@e....e.e@..e.@e.....
w.ee...ee@.@@e......e@.ee....ee@e..w
...@e...@eee.@..e.e....@e....e@e....
.........@@@ee.e@e@e@.ee@....e@@e...
w...e@e..ee@@ee@@e..e.@e@e@...e@e..w
.....e@.e@.e.e@ee.e...eee.eeee.e@e..
..e.@e@e@..@e@....@e...@.e.@@@..e@..
w.@ee.e....e@@e.e...e..e@@eeee.e@..w
..e...e@e.e@ee..@e..@e@ee@e.........