33,36
355
355
1000
..@e.....e@e......e@e@e@e@...e@.ee..
w.ee@e.e@@e..e...ee..eee.e.e..ee@@.w
......eeee@..@e..@@e@.@@e..@e....e..
...@e.@@e@....@e.ee.e.ee@@e@e@..e...
w..e..e...........@@e.@@ee...e.e@..w
.....@ee.....e.@e.ee@ee....e.....e..
....ee@@.e..e@.eee...@e.e..@eee..@..
w..e@e@ee@e@...@@@@e..e@@e.e@@@e.e.w
.......@e.ee..@eeeeeee.e@.e..e@@....
.......e..@@..e.e@@@@@e@e.@e..ee....
w......@e@ee.e.e.eeeee@.@e@e.e@e...w
......e@e.e@.@e@e@@e@....@....e@....
......e@..e@ee..@ee@e..e@e....e@....
w..e@e.ee@.@ee@....e@@e@e.e@e..ee@.w
.....@e.ee@e@@e.e@.@ee.e@.e@@....e..
......e@@e@..@e.eee@@e@..e.ee@ee@e..
w...e.@e@ee@.e..@e@ee.e..@e.e@.e@@.w
....@e..e@.e...e@..@@e@@e....e..ee..
...e@e..@e....@ee..eee.eeee@.@ee.e..
w.ee@e....e.e.e.@ee@@@ee@@@e.ee@.@.w
..@ee@e@ee@e@.e.e@..e@.@.e@ee@@.@e..
..@e@e@@e@@e@e@e@....e@e.e..@ee@ee..
w.e....e@.e....@.ee....e.@ee.....@.w
..e..e@e..@ee..e.@@e...@e@@@e.e@ee..
..@e.@e....@@e...e..e....eee@.e@@e..
w.@e@@e....eee.....e@......e@e.ee@.w
..e.ee@e...e@@.e.....e...e@e.....e..
..e@...@e@e@@e@@.....@e.e..e....e@..
w.@e..e@e@e.e.ee.....ee.@e.@@e.ee..w
..@e...ee@.......e..e@@e.e@eeee@@e..
..ee@e...e..e.e..@....e@.....@e@@e..
w.@e@@e@....@.@e.e...........e.ee..w
..e.e.@e....e........e@e.....@e.....