33,36
337
337
1000
..e@e..e@e@e.e@....e@ee.ee......e@..
w...e...e.e@.@e......e@.@@e.....@e.w
...e@@e..e...e@....@e@@eee@e@...e...
..e@@e.ee@..e@e.e@@e@.e..e.@ee.e@e..
w.@ee..@@ee.@e..@ee.....e@.e@@e@...w
...@..@e@.@..@e.@e@.........e@@.....
...e..e.e.e..@e@e@e@e@.......eee@...
w.e@e@e@.e..@e.e.ee@.e.......@e.e..w
..e.e@@ee@..e@.@.@ee....e..eee@.....
..@eeee@.......e@..@e...@.e@@.e.....
w.e@@ee.e@..e@..e.e@@ee@ee@.ee@....w
......@e@e...e.....e...e@@..........
..e.e@@e............ee...eee.e......
w.@@eee...e@@e......@@@e.@@@e@.....w
..ee.eee..@ee..e@e..eee@@ee.@e......
.....@@@e...@.e.........e........e..
w.e@eee@e...e.@e.....e@..e@@ee@.e@.w
..@@e.e@@ee@e.@e......e..eee.ee@@e..
..ee@e@e@@e@@ee@...ee....@...@ee....
w....@e.ee.ee@@...e@@e.e@e.e..ee.e.w
...e.....ee@..e...e@eee..e@@ee@@e@..
..e@@e@@e@e..ee@..@e@@@e.@ee.e@ee@..
w.@@e@ee@.@..@ee.e...e..e@e@e.e.@e.w
..ee.ee@..e@..e@.@e.....ee@e.e@.....
..@e.@e@e.@ee..e@....e@.@ee@.e@e....
w....e..@e@@@e.@e.@e..e..e@e.@ee...w
.....@e@@eee@@e...e......@e@@e@@e@..
...e@e.ee@..e..e.e@.@ee..ee@e.e@ee..
w.e@.e@.....e@e@....e@@......@e....w
..@e..e.e@...@e.....@.e..e@@eee@e@..
......@..e...e@@e@e.e.@e..ee@..e@e..
w..e..e.ee..e@.e..........ee..e....w
...@e..e@@e....@e@e....e@e@@ee@.....