33,36
358
358
1000
...e......@ee@e.e@ee.e....e@..e@@e..
w..@....e@e..@e.e@e@e@@ee@@e...eee.w
...e......e..e...e..e.e..e.@eee@e@..
..e@@e...e@e...e@e..@e......@@e@ee..
w.@.e@e..@e@e....e@e....e.e@e....@.w
..e..e@e..e@@....e@e@e.e@e@e....ee..
..e..e@@e..ee..e.e@e@e@ee.e@...e@e..
w.@...ee@..@e..@..e.@ee@@.@e.....@.w
..ee.e@........e.e@.e@@eee@ee@ee.e..
..@@e..e.............e.@..e@e..@e...
w.ee...@.e....@e.....@ee..@e@....e.w
...@e@eee@@e..e@....@e.........e@@..
...e@@e.e@e.@e.@e...e@....e....@ee..
w....e@e....ee.e..e.e@..e@@e.....e.w
..@e...@e.e..@e.e@@e@e...e.......@..
..e@@ee@ee@e.e@..e.e@e@e......@e.e..
w...e..e@ee@.@e.....@e........ee...w
....@eee@@e.....e.e@e..e....e.e@e...
......@ee.@.e@e.@e@@eee@...e@.@e....
w....e.@e.eee@e...@ee@@ee..e.e@@e@.w
....e@ee@..@@@e...e@.e@e@e@@@eee@e..
...e.e@@@e.eee.e..e@.@ee@eeee..@ee..
w.e@e@.ee..e...@..@e...e@.e@.....@.w
..@@ee@e@ee@@e.ee..@e..ee.e@ee...e..
..ee@.e..@@@e@.e@e@..e.@e.@e@@e.....
w.@....@eeeee@e@.eeee@e@e.eee@.e...w
..ee@e.e.@e@e@e..@@@@eee.e.@@e.@e...
....e.e@@e...e@..eee@e@@e@.e.@e@....
w...@e@.e@e@e....@e@@e@e.....eeee..w
..@ee...e@@e@e.@e.@ee.@e.....e@@@e..
..e@@e.e.e@e@@eee@....e...e@.e@e.e..
w......@.e@ee@e@ee.e@ee....e....e@.w
.......e.e@e....@e..e@@e............