33,36
347
347
1000
.......eee@.@e...@e...e@.e@.........
w.@e...@@@e.e....e.....e.@e.e@e@e..w
..e....ee..............@e...@...ee..
..@...@e@eee...e.....e@ee@e.e..e@@..
w.e...e.e@@@..e@ee...ee@.e@..ee@@e.w
..@e...e@@ee@e@e@@e@.@.e@@e@.@.ee...
....e..e@e@...ee@e@eee..e..eeee@@...
w..e@e....@e@e@.e.e@@@.....e@.e@ee.w
..e@.@....e.e.@e....ee.e@..ee.e@@@..
.....e.e@e..e@eee..e@.e.ee@@@e.eee..
w..e@@e.e@e...e@@....e@...eee...e@.w
....ee@.e@@..e@@e....e@e...@@e......
...ee@...ee....e.ee..@@e..ee........
w..@e@e@@e......e@@e.ee.e@@e...e@..w
..e...@ee...e...@.e@.e...e@eee@ee...
..@e....@e@e@e@.ee@..@e..eee@.......
w.e..e@@ee@e..e..e...e@..@@e@eee.e.w
..@e@eee...@e.e@e@.ee@e@eee@..@@e@..
......@@e.e..e@@e..@@e..@e@@e.e@....
w...e@e...@e@.ee@..e@eeee..e..@e...w
.........@e@e.@@e.e..e@@@e@....ee@..
.....e@eee..e@ee@.@e@..e..e.e@e@@e..
w....@e@@@eee@...e@ee.@e..e@e@e@@e.w
.....ee@e..@@ee@@ee@@ee@...e.e.ee...
.....ee@@e.e.@eee@e@e......@e@..e...
w...e@@ee@@e@e@@@@e@......e@...e@e.w
..........e...eeee.e......@e.e@@e@..
......@ee@e.ee@e@....e@e@..@.@ee.e..
w.@e..e....e@@e.......e@e@.e@e..e@.w
..e....e....ee.......e@@ee....e..e..
..e@e.e@e..e@@e@e....e@e.e....@ee@..
w..e..@e@.e@..@.....ee@ee@...e.e@e.w
..e@..ee@e....e....e@...e@e..@e.....