33,36
346
346
1000
...e@..e@@e@.e@e@.e@@e.e@@e@e.e@....
w..ee..eee.e....e.@ee@..ee.e@..e@..w
...@@..@@e..e@..@ee@.....e@e.ee@e...
...ee..ee@e@@e.........e@ee@.@@e....
w......e@@ee.@ee..e@e.e@@e...ee@...w
..e......e@@e@e@..@...eee@e..e.@e...
..@e.....@.e.e....e.ee@@e.@e.@.e....
w..e....ee...@ee@..e@e@@ee@e@e.....w
...@e@e@@...e@e@ee.@..ee....e@...e..
...e.e.eee@@e@..e@.eee@@e...@e.ee@..
w....e.e@eee.e@e...e@@ee@e...e.@e@.w
.....@e@@e...e@e..e.e.e@.e...@e@ee..
..e@ee..e.e......e@.@.e@e@..e@e@ee..
w.@e....@e@e@e....@eee@@e....e@.e@.w
..@ee.e@e@.@e.....e..@.ee@e.........
..e@@e.......e@e.@ee@e..e@....@e....
w...@e.e@e.e@e@e.e...@...e..@ee@e..w
....e..@e..e@e.....e.e......e@..@e..
....@...@e.e@e....e@..e@ee..e@ee@@..
w...e@e......ee@.e..e.ee.@...@e.ee.w
.....e@e...@e@eee@ee@e@@@e.eee@.@e..
.....e@@e@.e..@...@..@eee@.@@.eee@..
w..e.@e.@e.@e@e@.ee........eee@@@e.w
..e@..@e....e@eee@@@e....e@....e.e..
..e@...e..e@@ee@.@ee..e...ee@e...@..
w.@ee@e@.e.e@..e.ee@.e@e.e.@e@...e.w
..@e..@.e@..ee.@..e@e@eee@@e........
..e@.ee.@e...@.e@....e@@@.e@........
w...e@@e@e...e..ee@e@.@ee..e.......w
..e@@ee@@e@e@...e..ee.ee@.e@........
...e...@e@..eeee@.e@e@@ee@..e@......
w..e@e@e.....@@e@e...e@e@e...e...e.w
....e........ee@.....@e..e@e....e@..