33,36
360
360
1000
........e@.......e@.......@e.e@.....
w........ee..e..e.e...@e..e...e.ee.w
........e@@ee@..@.e@e.e.e.@ee.@e@@..
...ee.e.e@@ee@..e..e@@e.@e..@e...e..
w.e@@e@.@ee.ee@e...@.eee@..e.@ee.@.w
....e@@ee..e@@e@...e.e@ee@e@e@@@ee..
..@ee@ee@..@ee....e@...@e...@eee@...
w.ee.ee.@ee@ee@e....ee@.@........e.w
...@e@@ee.@e@e@e..e@@ee.e.e....e@@..
..e@e..@e.e..@e@...e@e@...@e@e..ee..
w.e@ee..e.@.e@e.e@e@ee@...ee@e.....w
..@e.@e.@@ee@@e..e@.@eee@e.@@e.e.e..
..e@.e..eee.@ee@e@...@ee@..ee..@e@..
w....@e@ee@.e.@e....e@.ee..@.ee@e@.w
...e.e.@ee...e@.....@e.@@e@e@@e@@e..
..e@e@.e@@e@e@e..e.....ee.e.ee.e.e..
w......e@e@...@e.@e....e.e@..@..e@.w
....ee@e@e.e@e.@e.ee@ee@e@e@ee......
....@e@e.@.e@@e@e.@e@.@e@.e.....e...
w.@ee@e@.ee.ee.@e@e.e....e@.e...@..w
..e.@ee@e@@e.@ee...e....e..e@ee@e...
..@e..e@e..........@e...@e@@..e@e...
w....e@@e...e@@e...e......ee..e@e..w
...ee..e@.e.eeee.@e@....e.@...e@e...
...@@.....@.@ee@.e@e@.@e@.e.........
w..ee.e.e@ee...@e@@ee.e.e..e@e@.e..w
.....e@.@.@@e@@e..e...e@@e..@ee.@e..
...e..@ee.e..ee.@e.....e.e@.e@..@e..
w.e@@ee..@ee@e..ee@..@e...ee@@e.e@.w
....e.@e.e....e.eee.@e.e..e..e......
.........e@...@.@@e.e.e@e@@e@e@.....
w...e@....eee.e.ee@..e@e.e.e@ee....w
.....e@e@ee@@e....e@e..@e@.e@e......