33,36
345
345
1000
....e@.....@e........e.e@@e.e@e@e@..
w....e.....e@......e@@e.eeee..ee.e.w
....eee.....e....e..e@eeee@@.e@.....
...e@@@.....@@ee.@e..e@@@@ee..@e@e..
w.e@eee@...eee.@e.@....ee@@e@ee.e@.w
..@e..@ee..@e..e..ee.e...e..........
...@...e@ee@@e@@e..@.@....eee.......
w..e.e@ee@.e..e.@eee@e....@@@@e....w
..ee..@e...e.....e@..e....eeee@@e...
..@@..e@ee.@ee@.ee@ee@..e@@e@..e.e..
w.ee...e@@e@@@ee@.e@e..@ee......e@.w
..@e@..e@e.ee.e@...e@e@e.@e.....e@..
..@ee.e..@.e@ee@e..ee@.@e....@e..e..
w.e@@e@..ee@e@e@.@e@@.e@e....e.....w
....e....ee@e.@e.e@@e.e@.....@e.....
.....@e..@e.....ee@e..@ee..ee.e@e...
w....e@e@@e.....@@e....e@e@@@e.....w
....@e..ee.e....e@.e@eee..ee........
....e.@ee@.@e.@e.e.e@e@@..@ee..e@e..
w.....e@@e.e@ee@.ee@e@.e....@e@ee@.w
..@e...e@@e..@e..@@@e...e..e@.......
..e@...@ee...e@.@eee....@e.@ee@.....
w....e...@e..@e@e.e@.....e@@e.ee.e.w
....e@ee@@e.@eee@.e@e...@eee@e@@e@..
..e.e@@eee@.e.@.ee@...eee.....e.e@..
w.@e@ee@..@ee.ee@e@eee@@@e.eee@e.e.w
.....e@@e.e@@@ee@e@e@.ee..e@@@......
..e....e@...ee..@e.e@.@ee.@@ee......
w.@..@e@........e@.@e..e@.ee....e..w
..e..e@.........e@e.@e@@e.@e@e..@...
..@ee....e@........e@@e@.e@....ee...
w..e@@e...e..e@@e...e@eee@e....@ee.w
..e@.e........ee@...e@e@@e......e@..