33,36
349
349
1000
.........@e.e.e..@e..e.e@...ee@e@...
w........e..@.@e.e...@..eee.@@..e@.w
.........@e.e......e.e..@@@@ee@e.e..
...........e@e....e@@e..eeee@.e@.e..
w.e....e@.e@e@@ee..ee.....e@....e@.w
..@ee@..ee@.e@e@@ee@@e...e@.@e@e....
..@e@e@e@e@.@ee@e@e@e.@ee@@ee...e@..
w.ee@.e@..e.e@.e.@e@e.e.e@e..eee.e.w
....ee@....@e...@e...e@e@..e.@@@e...
..@e.@e...ee....e....e.@ee@@eee.....
w.e...e..e@e@......e@@.eeee.@...ee.w
..@...@ee@@ee@e@e..@eee@@@e@e..e@@..
..ee..e.@ee@...@e..e....e@e.@e.e@e..
w..@e.@e@.....ee@..@e...e@e.e@.@e..w
..e@ee@ee@e...@e.e@e@ee@e@ee@ee.e...
..e@@e@e....e..@.e@ee@...e@e@@@.@e..
w..ee@e.....@e.eee@e@.e..e@.eee.e@.w
......@.......e@@.e...@e@ee.@e..@e..
..@ee.e....eee@.e.....e@.....e@ee...
w.e.@e....e@@@e........e@....@e@...w
..@e.@.eee.@ee@.e......ee....@eee@..
..e@@e.@@@ee..e.@e.@ee@@.....ee@@e..
w...e@@eee@...@e...e@.ee.@e..@e@...w
....e.e@.@@e.e@@e..@e....ee....e....
..e@@e...ee...ee@.....ee.e@e@ee.@e..
w..e@..........e@ee..e@@e..e@@@ee..w
....e@ee@e......e.@@e@e@ee@.ee@@....
..e.e@.e@ee.....@eeee@.e.@e..@ee....
w.@e@e....@e........@ee@e@e........w
...@e...ee@ee@e........e@@e....e....
...@e...@e@e.e.....e..e@@e@e..e@e@..
w..e.....e@@e@.....@ee@@ee.@.@e@.e.w
.........@ee.e@e..e@ee@e.@ee.e.e@e..