33,36
358
358
1000
..@e..e@e..e@e@e@.e@@e..........e@..
w.e...e@..ee@e..e.@ee.e@......e..e.w
..e@e@ee.e@......e.e@e@ee.e@e@@.....
..@@e@e.e@.e...@e@e@@e@e@..@eee.....
w.ee.......@e@ee@@e.e......e@@@e...w
....ee......e@@e.e..@.....@eeee.e...
..e@@@e.e....ee@.e..e.....ee@.@.@e..
w..ee.ee@eee@e@.e@.......e.@e.e....w
....@e@@ee@@ee..@@e...e..@e@e....e..
....e@e@...e@@.@ee.e..@e@ee@ee...@..
w......ee@e..eeee.e@@ee@.@ee@@...e.w
....ee..e@@e.e@e@...e@@....e.e......
...e@@ee.ee.........eee....@e@.e.e..
w...e@e@..@e@..e@..e@@e...eee@e@e@.w
..ee@...e.e@ee.@e.....ee@e@@..e@.e..
..@..e..@e...@@e..e@e@@....ee@eee@..
w.e.e@@e@e...ee......eeee.@e....ee.w
....e@ee@e..ee.e@.ee@@e@@ee@...e@@..
.......@e..e@@e@e@@@e..@e@@e.e@e.e..
w..e@e....e.@e@..ee....eee@e@e.....w
....e@.@e.@eee@e@ee...e@@.e....e....
.......e......e@e@@e@.@ee......@e...
w..........e.@e@e@e@e.....@e@e.....w
.....ee.e..@.e...@e.e....@ee@e.e@...
....e@@e@..ee.@e.eee@@e..e.@.e..e...
w..e@@e...e@@ee...@eee..e..ee@e....w
...@@ee@e.e....e@.@e@...@e..e@@e.e..
...ee@e...@...e.e@e.e...e@...ee@e@..
w.e@..@..ee.e.@..e@.@..e@eee..e@e..w
...ee.e..@ee@.e@e@@ee@.ee@@@..@e@...
...@@ee....e@@e.@ee@ee.@@eee@e......
w..e..@ee@e@ee..e@e@@..ee@e.ee@e...w
..e@e@e..e@....e@..ee..@ee@e@@e.....