33,36
354
354
1000
.........e.e@e.e@ee@...e@e..........
w.e..e@ee@.@.e.@e..e...e@@.....e...w
..@e..@e..ee.@e@....e@e.ee.....@@e..
...@e@e.e.@e..@e......@e.......ee...
w.....ee@e@ee.e....e..e@e..eee...e.w
....ee@@e@e@@e@....@e.@e@..@@@e.e@..
...e@e@ee@e.e.....e........eee@..e..
w...@e@....e...ee.@e....e..@e@@e.@.w
....e.e.@e.@e@e@@.e@.@ee@e..e@ee.e..
...e@e@.e@e@ee.ee.@..ee@@e....@@e...
w...@e.....@e@.@@.e@e...e.....eee..w
..e@e.e@e..e...eee@e.e.......@e@@e..
.....e@e@..e@e@ee@e..@e......e@.@e..
w...e@@e@..@@e..@ee......@e.....e..w
......e.e@.ee@..@e@ee.ee@ee..e@@e...
...@eee@ee@@eee.ee@@@e@e@e@...ee....
w..e@@@eeee@e@@e.@ee@e.e@.e@e@ee@e.w
...e@e.e@@e@e...@e......e......@e...
...@@e.e@e.@e...e@e@...@e....ee.....
w..ee...e@@ee.e@@e@e..ee@...e@@@e..w
..e@....e@ee@.@ee...e@@..e@.@eee....
.......e.@e.e@e@@e...ee@e.e.@e@.....
w....e@@ee...ee.......@e.e..e..e...w
..@e..e@e.....@e....e@e@.@ee..e@....
..ee@.e@ee@e@e@@...e.e.@ee@@...e@e..
w..ee.....e.e.ee...@e@.e@e@e...@@e.w
..e@e@e.@e.........e@...e@@e...ee@..
....ee@.e......e....ee..@@e@ee......
w.@e@@e@e.....e@....@@e.ee.e@@e....w
..e.@e.e@e....e@.e@eee.e..e@ee@e.e..
....e..@e.e@ee.e.e@e.@.@e.e@e@e@e@..
w.e....@e@@.@@e@.e@e@e.e@e@@e@e.e@.w
..@ee@ee.ee.e@e...e@...e@e.e.e@..e..