33,36
350
350
1000
..@e..e@e..e..e@ee@.....e@e..e@e@e..
w.e..e@@e.e@@e.@e.e.....e@e...e....w
..@....e...ee@.e@e@@ee...e.@e.@e....
..e...ee@e.@ee.....e@@e..@ee....e...
w.....@e..@e@@e.......e@.@e....e@..w
..@ee..e..e............e@e.ee.......
..e.@e.@e.@e@e..e@e@e..@e.e@@e......
w...@e.e..@e@e...e@..e....e@e@.....w
....e.e@..e@.....e@..@e...e@e..@e...
....@.......e@e...eee@@eee@@e..e@...
w...e@e@.........e@@@e.@@e@e.......w
....@e@e@..e.ee@e.ee...e@@ee.e@e....
...e@...e.e@e@e@..@e.e..e@e@.@e@....
w..@e...@e@ee@@e....e@@eeee...e..e.w
..e..e@..ee@.ee.e...e@e@@@@e..@.e@..
..@e..e.e@@ee@@e@e..@e..ee.@..e@e...
w.@e.....e@@e@e..@e....@e@.ee@@e...w
..e....e.@ee.e..e@e...@e.e@e@e..e...
..@.@ee@e..@e@...@e@e.ee.ee...e@@e..
w.e.e@@ee..e.@e..e.e@.e@e@@.e..e@e.w
...e@...@ee..e.e@@.ee@ee@ee@@e.@e...
...@e..e.e@..e..ee@@@@e.e@.e@e......
w.e@e..@.e.ee@...@eeee.e@e....e....w
..@eee@ee@.@ee.@e.@e...@e....e@e....
..ee@.@ee@e.@@ee..e@e@e@e...e@@ee@..
w.@e@.ee..e.e@...e@@e@@e@.....e..e.w
..@ee.e@.e@..e.ee.ee.ee.............
..e...e@e..e@@e@@e@e@e...@e.@e.e@e..
w.eee@e@@e..ee@@e@.e@e...e..ee...@.w
..@@e@@e.@..@e@e...e@e...e@e@@e..e..
..eeee@e.e........e@@e......ee......
w...@e.@e@e@e.ee..e@e@....e@@@e@e..w
.......e@e...e@@e..........ee.e@e...