33,36
343
343
1000
.....eeee@e.....@e.ee.@e@@e.e@ee@...
w...e@@@@e@..e@ee..@@ee.eee@e...e..w
..@e..ee.e@ee......e.@.e@@ee@.e.....
..e...@e@@e.@e.......e@....e@e@.....
w....e@ee@@ee@.@e.@e.@e.e@...e@....w
..@e@e@e.e.....ee.e...e@ee.ee@e.....
..e.e...e.......@.....@e@@e@@e...e..
w.......@e@e...ee@..@e..e@e@e....@.w
..e@e...eee.@e.@ee..e@@e.....e@e.e..
..@@e.e@e@@ee.......@@e.e@..ee@ee@..
w.ee...e@e@@e@e...e@ee...e@e@..e@..w
..@@......ee@@e@e..e@e@eee@ee@e.....
..ee........@e.e.e.@e@.e@@e.@e@.ee..
w....e...ee.e.e@e@.@e@..e@ee.e@e@@.w
.....@...@@e@.e@e@@e.e.e@e@@e....e..
.....e..@e..e.e@.ee@e@.....@e...e@..
w.e.ee..e....eee.@.@e......e...e@e.w
..@e@@e@ee@ee@@@@e.eee..@e..e@e..e..
....e@..@@@e@@eee@@e@@.ee@e@ee..e@..
w....e@eeee@.e.eeee..e.@e@.e@@.e...w
..e@e...e@..e@e@@@e....e@ee..e.@e@..
..@e...........@ee@.......@e...e@e..
w.........eee@.e.@......e...e@e.e..w
.......e@e@@@e.@ee...e..@....e@e@...
..........@e@@..@e...@e.e@@eee@@....
w.e....e..e.eee..........eee@@ee...w
..@ee@.@ee@.@@@e.......@e@@@e@@e....
...@.ee@e@e.ee.@e..@e..e..e..ee@e@..
w..e...e..@e@.e@@e@ee@e@.....e@..e.w
....e@...e@....e.e..e@e.......@e....
...@ee@e.@e@e.e@.@@e.@e......ee.e...
w..e.....e.....eeee..e.eee@.e@.e@..w
..e@.....@e...e@@e....e@@eee@e.@e...