33,36
367
367
1000
..@e.e@e......@ee@e......e@ee@@e....
w.e..e..@e....e.e@e.e@..ee.@eee....w
.....@@eee@...@e@@e.@e.e@@e.....e@..
.....ee...e.e.e..eee@@..e@e@e@...e..
w.@e.e@eee@e@e@.ee@.ee..@e...e...e.w
..ee.ee@@e@e@@@e@e@e..e..e...@e@e@..
..@@e@.e@ee@eeee@@e@.e@ee@@e...e@e..
w.ee@..e@e......eee@e.e@@@e@e@e@...w
..............e.e@.e.e@@ee...e@@e...
..e@ee@ee..@ee@...e@e@.e.......e....
w..e@@e@@..e........@e..e@e.....e@.w
...e@ee.e..e@e...e@e.@e.@...e.@e@e..
......@e....e@..........e...@ee.....
w....e@....e@...e@e..e..e@..@e.e@..w
..e...e....e@@e.ee@.e@e.@e@eee..ee..
..@...eeee..ee@e@.e...@e..@ee@e.e@..
w.e.@e@@@@.@ee@@@e@.......e..e@.e..w
..@.e..eee.e.eeee@.........@e..e@e..
..e.@......e@@@e@@ee....e@.ee..@e...
w...e.e...e.ee@e.ee@....eee.@@ee@..w
...@e.@e.e@e..e@ee@..e@e@e@@ee.@ee..
..ee@e...@@e.e.e@....@e....e.e...@..
w.@.e@...ee.e@e@..e@.e@e@ee@.@ee.e.w
..e.e@e@....e@e@e..e.@e..e@@e.e@e@..
..e....e.....@e@e@.@e@e...@ee@@e@e..
w.@e@e@@e....ee..e..e@e..ee..e@e...w
..ee@eee@.ee..@@e...e@e.e@..e@.@e@..
..@ee....e@@e@ee...e.@eee@e....e.e..
w.@e@e@e.@e@...@.ee@.e@@.@e.@e.....w
..ee..e..e.e@e.ee@..e..e.e..ee@e.e..
..e@e.@....e@@e@...e@........@e@e@..
w...@ee@ee@eee@....e@..e@e@e....e..w
......e@e@.@e..e@e..e...ee@e...e@e..