33,36
357
357
1000
..@e......e@.e....e@.....e@e@..@e...
w.e......e.e.@ee@.ee......e.ee.e@..w
..e@....e@....@ee.@ee.....@e@@e@....
...e@...@@e...e@...e@.e@ee@.e@@e....
w..@e.eeee.e@e@.....e..e@@e..ee....w
..e@e.@@e@....e....e@..@e..ee.@e@...
......ee@e...e@.ee......e.e@@e@ee...
w.@ee.@e@@e..@..@@e@ee.e@...ee@e...w
..e.@..@e....eeeee@e@@....e.@ee@....
..e.ee..e@e..@@@e.@e.e..e@@e.e@e@e..
w.@e@@e.e@e@.ee@e@e......e@@e@..e@.w
..@ee@.....e...e.@e.......e......e..
..e..e@..e..e@e..e@.......@e.....@..
w.e@e.ee.@ee@.....@ee@......e@...e.w
..e@e.@@.........@e.@e....@e.ee@ee..
..@@e.ee..e.ee...e..@e..@ee.....e@..
w.eee....e@e@@@ee...e...e....e@e...w
....@....e@@@ee.@e.e.e@ee@e@e..e....
..e.e..@e@eeee@..ee@e@e@.e@e@.e@....
w.@e@eee...e.e@e@@@ee@e@e..e....e@.w
..e..@@..e@@.e@.ee..eeee...@e..@ee..
..ee@ee.e.ee..e@....@@@@e.e@@e@e....
w.@@e.e@@ee@...ee...eee...@eee.e@e.w
..e.@..e@.e.e@e@@e...e@.e@@e@@e..e..
...eee..ee@e@e.e@....e@e.ee.e@e..@..
w.e@e@..e@@e@@..e....@e@...e@@e@.e.w
.........@e.ee.e@e...e.....e@e.e....
..ee@e.e@e.e...@.@...@e@e@@e@@e.....
w.@e...@e..@...e.ee@e@@e@ee.ee@.e@.w
..@e@e@@e@.e...ee@.@ee......@.e@.e..
..e...ee.e..e@e@ee@e......e.e..e....
w..e@.@e@.e@e.@e@@e.eee@..@ee.e.e@.w
....e.e@e.e@e.e....e@@ee@e@e@e@..e..