33,36
352
352
1000
..e.....e@.e..ee......e.@e@e..e.....
w.@.e.e..ee@ee@@e.e..e@.ee....@e...w
..ee@.@e...e@....e@e.e@..@e..e@e@e..
...@ee@....e@e@ee@e@..e.e@ee..@ee@..
w...@@e....@e@.e@.ee@...@e@@e.e@...w
....e@e...e@....@e@@e.e@e..e@.......
.....e@....e.e.eee@e....@@e...e@....
w.e.e@.....ee@.@e.e.@e.eee@....e...w
..@e.......@..e@e.@ee@e@......e@@e..
...e@......e.e.@e.e@eee@...@ee@ee...
w...e..ee....@eee.@.@@.e.e.e@.e@e..w
..e@..e@@.@e.@e.@.eeee...@e...@e@...
..@eee..e.e..e..ee@@eee@e....ee.....
w.e@@@@e........@e@ee@ee....e@.....w
....eee@..e.....ee@..e@@.e...e@e....
...e@@@@ee@..e.@e.e...@e.@..e@.@e...
w..@@eee@@.ee@@e...e@ee.eee@e.e@e..w
...ee..e@ee@e@e@......e@@@e@e.@@e...
..e.......e@......e@.@eeee..@eee....
w.@e..e@e.@ee...@e.e.e@@e.@ee@ee...w
..e@@ee@e@e.@.@ee..e..e@@ee.e@@@e@..
....e...e...e@e.e..@e.ee@e..@ee..e..
w...e..e@....e@.@e@ee.@e@e..e@..e@.w
...e@.ee.....e@e@e@e@@e@e@......e@..
.....e@@e....@e@eee@.e...e@..e..@e..
w..e@e@e@.e....e@@........e..@@e.e.w
..ee@..e@e@......ee...e@e...eeee@@..
..@ee.@e.@e...e@e@@e.e....ee@@e@ee..
w....ee..e@..@e...e@.@e...@@e.e.e..w
..e.e@..@e..ee.@e@e@e@....e@ee@e@...
..@.@e@ee@..@.@e...e@e.....e@e@eee..
w.eeee.....@e.e.e.e@..ee@....e@.@@.w
..e@e@.....e@...@e@..e@@e....@e.ee..