33,36
352
352
1000
...@e.e@ee.....e@e@e....e@ee@@ee....
w.ee@.@e@@e@e.e.ee@@e.....@eee.@e..w
..@.....e@@e.e@.@@e.................
..e......ee@...ee.e@..e@eee.e.e@e@..
w.@e........e..@e@.e..e@@@@e@.e@.e.w
......@e...e@....ee..@eeee@e@.@e....
....e@e@.e.@ee..@e@..e.e@e@@e.......
w...@.e@e@e.@@e.e.e...e@..e.e@e@...w
....e.@.@.@@e@e@e.@ee.e@e......ee...
....@ee.eeee..e@e@ee@..e....e..@@e..
w...@e.e@@e......e@.@ee@@eee@e.e@e.w
....e.e.e@..e@.ee...e...ee@@@ee.e...
..@e.e@.@e...ee@@e........@ee.@e@e..
w.e...e.......@e@e........e.ee@e@e.w
..@..e@....e.e@e..........@.@e@e....
..ee.@e....@@e@e....e@.@e.e.e@@e....
w.@@.e.....ee.e@e@e.ee.e.e@e..ee@e.w
..ee.@.........@e@e.@e.ee@..e.......
...@ee.ee@ee@e@ee..e@ee@@ee@@e......
w.e@ee@@e@e.@e..@.e@e@@e@@eee@e....w
..@e..e@@e..e...e.@ee@e.e@ee@.@.....
...ee..e@..@ee@e@....@e...@..ee@ee..
w..@@...e..e@.e.e@e.@e..e@ee@@.e@@.w
...ee..........e@@e.e....e@eee...e..
.....@eee.....e@ee.....e@ee@........
w..e.e.@@e@e.e@@ee...e.@e@e@e..e@e.w
..e@...e@.e.e..e@@@e.@e.e@@e@e@e.@..
...e@e@ee.@.@e...ee......e..e..e@e..
w..@.@....e..e@e....ee...e..@.e@e..w
...e.e....e@....ee@e@@e@e@e@e.@ee...
...e@e@e..@e...e@@@e@..@e@e...e@@e..
w..@e@@e.....e@e.ee.ee.ee@e..ee..e.w
......e@....e@.e@e@..@e.e@e@e@@ee@..