33,36
365
365
1000
...e....@e...@e@e..e@ee@ee@e.e@.e@..
w..@e.@ee....e.e........eee@.@e..e.w
....e.e.ee@e@e.@ee..e@..@@@e....e...
....@@ee@@e@....@@e..e.eeee@..ee@e..
w...ee@.....e...e.ee..e@.e...e@@e..w
....@ee@@e..@e..@e@@@e.e@@@e.e......
..e..@@ee......@e@.ee..@eee.e@@e....
w.@..e......@e.e.@e.e@e@ee....ee@e.w
..eee.e@e...e....e@.e@e@@@.....e@@..
..e@@..e@............e.eee......ee..
w.@ee@.@ee..e..e@ee@e@.........e.e.w
.....ee@@@..@e.@e.ee..........e@.@..
.....@eeee.e.e.e@e@@e.@e......e@ee..
w.........e@e@e@.e.ee@e......ee@...w
.......ee.@ee....@e@@.ee@.ee@@ee....
..e@eee@@ee@@e@..ee@ee@eee@@e.e.....
w..ee@e@..@ee.e..@e...e@@e...e@....w
...@ee@e....@....@e.e@@e..e.........
...e.@ee..e@e....e...e.e@e@.ee@@e@..
w..@ee.@...@e..@e.e@e.......@eee.e.w
...e@@@e..ee..eee.e@@...e......@e@..
...@eee...@e..@e@..eee@e@e...e......
w...@e....e@.e@e@.....e@...e@@@ee@.w
..e@e.e@..e@e.@ee...e.......eee..e..
..e@..@e@ee@e.e@.e@.@e.ee..ee@......
w.ee..ee.@@e..@e.@e..ee@@ee@..e@ee.w
..@..e@@ee.@e@e..e..e@@ee@e@e..e@@..
..ee.@e@ee@e..e@.@..e@@ee@eee...ee..
w.e@e@e.e@e@.e.eee@@eee@...@@ee.@e.w
..@e.@e.e@e.e@e.@.eee@@@e.@ee@@.@e..
..e@.e...@e.@...e@@ee.ee..ee@@e@e...
w....@..ee..e.e..e@e@e@....@.e.e@..w
.....e.e@@ee@.@e..e@.e@e@e.ee@e@....