33,36
362
362
1000
..@e..e.e@.@ee..e@@eee.e@e....e@e...
w.e...@e.e@e@@e..eee@@@e......e@e..w
..e...e@e@@e.@e....@.eee@@e...e@e...
..@....@e.e..e..e@eee..@ee@....e@...
w.e....e.e@e.......e@.e@@e.ee..@e..w
.......e@e@@e..e@..e@..e..e@@.e@ee..
.....@ee@@e@e@.@e..@e.e...e@e.e@e@..
w.@e.e.@e.e@@ee@..e...@..e@....e...w
..e@....@e@e..ee.e@.e@e..@e...@ee@..
...eee...e@e.e@e@e..@@e...e@..e..e..
w..@@@e.@ee.e@.....@eee....e@e@e...w
...ee@e.e.@e......ee.e@...e@.@@ee@..
..e@@.e..e@e..e@e.@ee@e@..@eeee..e..
w.@ee.@e@.....e.....@..e..e@@@e..e.w
..@e.e.@e@.@e.@e...ee..ee.@ee@e.e@..
..e..@...e.e@..e.e@@.e@@@e@e..e@e...
w.e..e..e@e....@eeee..eee@...e.@e..w
..@e....e.@...ee@@e....e...ee@.e@...
..@ee..e@ee..e@@ee@@e..@eee@e@@e....
w.ee@..e@@.ee@@e.@eee.e@@@..@ee@e..w
...e@e@.eee@@@e..e@@@e.eee.eeee@@e..
..e@@ee@e..@ee...@ee@e.@ee.@@@@ee@..
w..ee.e@@e.e.....e@e...ee@eeee.....w
..e@@eeee@e@......e@@ee@..@e@..ee...
...@ee@.@.@e@.......e.e...e...e@@e..
w..e.e@.ee@.e@e@e...e.@e.e@..e@@e..w
..@e.@e...e..@e.e@e@@@e..@e....e....
..e@.@e.....ee...e@eeee@e...e.......
w....e.....e@@e....e@......e@.e.e..w
..............ee@e....e......e@.@e..
........e.....@e.@....@e..@ee@eee@..
w..@ee.e@.....e..e.ee....ee.@e@@@e.w
...ee@.e@e@e..@e..e@@e..e@@ee..ee...