33,36
365
365
1000
...e...ee@ee@e.@e.e@@ee@e@..........
w.e@@ee@@e.e@@ee..eee.@e.e.@e......w
....eee@e...e..@e.@e@..@@e.e.e.e@e..
.....@e@......e@ee..ee.ee....@@eee..
w......e......e.@@e.@@e..e.e.ee.@@.w
.....eee@e....@ee@..e..e@@e@.@e@ee..
.....@@e@e.e@....ee.....ee@....e....
w...eeee@...ee@e..@e@e.@e..ee@.@ee.w
..e.@..@e.e@@@....e@e.@e.@e@.ee@e@..
..@.e@ee@eeeee.....e@ee..e.....ee...
w.e.@e@@e@@e@..e@ee@@e..e@e.....@e.w
..e@e..e..e.....e.e@ee.e@....eeee...
........e.@e@e..@e@.e@..ee..e@@@@e..
w.......@e@e@e@ee@.e@@ee@@..e@ee@..w
..e.ee.@e..@e..@@e.@ee...e@ee@@ee...
..@e@@ee...ee..e......@e....@e.e@...
w......@e.e@@e@@e.....ee@e@ee@e@...w
...e@ee@e.@...e....e@e.....e@@e@e@..
.....@e@e.e.................@e.e@e..
w.@e.e.@e@e@e..........eeee.e.e@...w
..e....ee@ee@e@e@..e.ee@@@@e..e@.e..
.......@...@eee.e..@e@@eee@e...ee@..
w.....@ee...e@e@e.e@ee@e..@e....e@.w
......e.@e..e@e......@e...e@...e@e..
......ee@@e...e.....@e.@e@e@e.e@....
w..eee@.e@e..e@e...@e..eee@@e.@e...w
..e@@e..e@e@ee@@e@.e.e@e@.ee@e@e....
..e....e@ee...e.@ee....e..@e.e@@e...
w.@e..e@e@@@e..ee@@e@e@@e..e@eee@..w
..@e.@e...eee@e@....e.e@e.e..@e..e..
..e.ee@e@e.e.e@@e...@eee.e@.e@e.e@..
w.@e@@e.e..@e@.ee...@e@@....e@e....w
..e.....@e.e@e..@e..e..e.e@e.e@.....