33,36
365
365
1000
..e...e@e@.@e...e@.e@e.e.@e...e@e...
w.@..eee.eee..@e@e@e@e.@@e@.e@e@...w
..eee@@@ee@@e.ee@.e....eee@ee@ee....
..e@@@ee@@e@@e.@e.@e@e..@...........
w...ee..ee.e.....e.e@ee@e.e...e.e..w
...ee...@..@.@e.e@........@e.e@.@e..
..e@@...e@ee@e.e@@e..ee@ee@e@@@ee@..
w.e@ee@.e@e...e..ee..@@..e@.eeee...w
..e@@.e.e@e...@e.e@..ee@..e...@@e...
...eee.@e.@e@e@e..@eee.e..ee..e.....
w...@@ee.e@eeee@..ee@@.@ee@@e......w
...ee@e..e@e.@@e...eeee@ee@@e..e@...
...@ee@@e@.@.ee@.e.@@e....ee....e...
w....e.e...e...e.@.e@ee.ee@e....e..w
..e.e@..ee@ee@e@ee....@.@e@@..e@@...
..@e..e@@e@ee@@.@e....e..@ee...ee...
w.@e...e.@ee.ee......e@............w
..e.@e@ee@e@.@.....e@@e.e.@e.@ee....
...ee@.ee@e..e...e@.e@e.@ee.ee@@....
w..@..e@e@e..@e...e....e@e@.@e@e.e.w
..ee.e..e@@e...e.e..@e.@e@.e@@eee@..
..@.e@ee.e.@e..@e@@ee@e@e...e.@@@e..
w.e..e@@e...@ee@@ee.ee.@e...@eee...w
...e@e@@e...e@.e....@@@ee@......e...
....eeee.e.....@e..@eee@@e....e@@e..
w.@e@@...@e........e.e@e.......e...w
..e..ee.........e...e@eee....ee@....
.....@@e.....e@e@@ee@@e@@ee@e@e@....
w..e.e@@e....ee..e...e....@@e..e...w
...@e@e@ee..e@@e....e..ee.ee...e@e..
...e@@e@@@ee@.......@ee@@e..ee...@..
w....eeee@..e.....e..e@e@@ee@@...e.w
..e@e.@e.e.e@....e@.e@..e.e@.e......