33,36
358
358
1000
..@e.@e@e..@e........e@......e@e....
w.e.@ee....e@........@e.e@e......e.w
..e.e@@e@e@@.e..e@.@e...e@@..e@ee@..
..@e..@e@.ee.@e..e.ee...@ee..e@e....
w...e.e.eee.e@e.e..@@..e@e@....e...w
...e@e..@@@ee@ee@..eee..e@e@..e@e@..
..ee.@e.ee.@e@e@.....@.....e..ee.e..
w.@@e@e@.@.e..e@....@e...e@e.e@@e..w
..e@.e.e@e.@..ee...ee...e@e..ee.@e..
...e..e@@e.e@.@e..e@@@e@e@@.e@@.e@..
w.@e....e...e..e....ee.e.ee..@e.@e.w
..e..e@.e@e.eee@.e....e@e.@e@e@.e...
.....ee..e..@@e..@e...@e@...e.e.@e..
w.ee.@.e@@e.e....e.e...e@..e@.@....w
..@@.e..e@@....ee@.@...@e..@e@e.....
..eee@@e.ee.eee@.e@e..e@e.e@e.e@e...
w...e@e.e@@.@@e@e@....@ee.e@..@.e@.w
.....@e.@ee.e.e.....e@e@@e.e..e@.e..
.....e@.......@e@e@....e@e.....e....
w.ee..@e.e@e.e@ee.e@.....e..@e.e@..w
..@@e.e..@e..e@e@..e....e@.eeee.ee..
..e..@e..e@e.@ee....ee@.@ee@.@@..@..
w.e@ee@....@e..@e.@e@.ee@@@e.eee.e.w
..e@e.e@..e@ee.e@.e@@e..ee@e..e@ee..
...e..ee....e@e.....e@@eee@e@ee@@@..
w..@..@e.@ee@e@.e@e...e.@e.....eee.w
...e..@e.e....e@@..ee...@e...ee@.e..
......e@.@e....ee..@@e..e@.e.@@@e@..
w.e@e@..e@e....@e..e.e@e..e@.eeee@.w
...e@e..e@@........@.e....@e.@@e.e..
......e@eee@eee@e..e.@..e@@e.e..e...
w..@ee@e@@e@@@ee@e@e@ee..ee..ee.@e.w
...e@@e..e.ee@e@......@e....e@@e....