33,36
352
352
1000
......e@....ee@e......@ee.e@...ee...
w.@e...e....@..@....e@e@@e.e..e@@e.w
..e@...e.ee@e@.e.e..@..e@@e.e@@e@...
.......@e@e@ee@e.@e@ee..e@@e.e..e...
w.e@e.....@e@.@e@e...@...e@e@e..e@.w
...e......e...e.e@.@ee.......@e@.e..
...@e..ee...e@e....e...e....eeeeee..
w.e@e@.@@e.e.@e........@e...@e@@@@.w
...e@e.e@@e@ee@.......e@ee..e.@eee..
..e@e...ee@@ee@e@.e....@e@....e.e@..
w.@e.......e@e@eee@e...ee@e@e.@.e@.w
....e..@e...@e....e@e@e..@ee@.ee.e..
..e.@.@e@...e@e@ee@.e@e..e@....@e@..
w.@ee@e.......e@..e@e@@..e@@e..ee@.w
...............ee@ee.ee...ee@.e@@e..
..@e.e...e..e.e@......@...e..ee@e...
w.e.e@@e.@..@ee@e.e@e@eee.@e.@.e@..w
..@.e@e@.e..e@.@e.e@..e@@ee@.ee.....
..e..e....ee@e.e...e....e@...e@e....
w....@e@e.@ee@.@..@e.e@e@....@@e...w
..e@e....e@ee..e..e@.e@@e@e..ee@....
..@e..e..@e.@@e@e@..@ee.e@e..e@.....
w.@e..@e.e@.eee@@e.ee.......e@.ee@.w
..e..e@....e@e@e.e@@@..e.@e.e@e@.e..
..@..@e...e@.@e@.@eee..@ee...e@@e...
w.e...ee...ee.....e@.e@ee....@.e.e.w
.....e@@e..@@..e.e@e@e@e@....e...@..
....@ee@e.@ee@e@ee@e@.e.@e@..e...e..
w...e.@@e.e.e@..@ee.e..ee.e..@e.e@.w
......ee@eeeee..e...@ee@..@ee...@e..
..ee....e@@@@..e@e..e..ee.e@@.e.....
w.@@eee.@eeee..ee@..@e@@@.@@ee@....w
..e.e@@ee@.e@.e@@e..e.eee.ee........