33,36
363
363
1000
..e.e@.e....@ee@ee@ee@e@...@e@e@e...
w.@..ee@...ee.e..e.@ee.ee@.e.@e....w
..e@e...eee@@e@..@e.....@e.e@e.e@e..
.......e@@@@e......e..e..@e@..ee@e..
w....e@e.eee@.....e@..@e.....e@..e.w
..e@e@e@.e@......e.e..e@..e@@e.e@@..
..@ee@e.e@e.e.@ee@e@.......ee..eee..
w.e@e@.ee@@.@eee@@e.......ee.e@@e..w
...e.ee@.ee..@@eee...e@e..@@e.e@....
...@..e@e....ee@@ee..e@e..e...@e....
w..ee@.@e......e@@@e....e@e@..e.e..w
...e.e@ee....e@eee@e@ee..@ee.e@e@e..
...@e.e@@e..e.e@e@e@@e@..e....e@.e..
w.e@@.@e@e.e@..e@.e@ee@e@e.....ee@.w
..eeee@ee@.e@ee@e@.e@@e......@e@e@..
..@e@e@@e@e..e@@ee..e@e@...e.e.@ee..
w..e@@e....e..@e...e@eeee.e@...e@..w
....e.@..ee@..e@...e.@@e@e...e@@....
......e.e@@ee......@eee@e@.e@.ee....
w..........e@e@e..e@e@....eee.@e@e.w
..ee@..e@e@@@e.e@e@..e@e..@@eeee@e..
..@.e..e.@eee..e@eee@@e...ee@@@ee@..
w.e.@..@...e@e....@ee....@ee@e..e..w
...@e.@ee.e@...e@eee@...@e.e@e..@e..
...e..e@@..e....e@@e@...e.@e..e@e...
w......eee@@e.....e@e.e..@e.....@e.w
....e@.@@.e@e...e@..e.@..e@.@e@.....
.....e@ee....e...e..@.ee.@e@e.e.....
w.e..@e.ee...@e..@e.e.e@@e.e...@e..w
..@e.@ee@@e...@e.....e..e..@e.eee...
..@e.e.ee@...@e@....e@.....e@e@.@e..
w.e...e@eee@.e.e@e..e@.....@.@@e.e.w
..e@e..e@@ee.........e.....e.ee.e@..