33,36
350
350
1000
...e@e....e@.@e....e@.@e........e@..
w..@@e...eee@e.e....e@e..........e.w
...ee@@e@@@@e.e@...e@.e@e...e@e.e@..
....e@e.eee@@..@e@e..e@e....ee@.e@..
w...e@eee@.ee..ee@e.e@@e...e@....e.w
...e@e@@@e@@e.e@@@e...e......e..e@..
..e....e@.e@e.e@ee@..e@.e.@ee@e..e..
w.@eee.@e.e@..e@e....e@e@.e.e@@ee@.w
..@e@@.e@..eeee@ee.e.e@@@e@.@e..@e..
..e..e...e..@@@e@@e@.@eee....@e.@e..
w...e@...@.eee..e@e......e.@e...e..w
.........e.@e.......e@ee@@.e...e....
..@ee@ee....@e.e@......@eee@@ee@....
w.e....@e@e.e@..e.e@e.e@e.e.ee@....w
......@e@e@@e.@e.@e@e...e@@e...e....
..e.@ee.@e.e.ee..ee@e....e.....@....
w.@ee.@.ee.@.@e...e@e...@e.e@e.e.e.w
..e@e@e@e@.eee...ee@e...e.ee@@e..@..
......e..e@e@@e@e@@e..e..e@.e.@e.e..
w.e@.e@..e@e.e@ee@.ee@@e..e@..e@e@.w
...e.e@e@e@e@e@..e.@ee@ee@@e........
..@e@ee.e@.@e.e@e...e@.@.e..e@e.....
w.e...@e@..e@.e@..e..eee...e.....e.w
..e@e@e@......ee..@ee@@e..e@....e@..
..@e@e.......e@@e.@e@@e....e@...e@..
w..e@@e....e.@e@.ee..e.@e.e@ee...e.w
....e.e@e..@e@ee.@...@eeee@ee@...@..
..@e..e@e@ee.e@.@e@e...@@@ee@..eee..
w.e..e@@e@e@.@@ee.@e...eee.e...@@e.w
.....@ee.....ee..ee..@e@e@e@..ee....
....ee........@..@..ee@@ee@..e@.....
w...@@........e..e..@.@e@e@@ee.....w
....ee..............e.e...ee@@e.....