33,36
347
347
1000
....e.e@.....e.ee@@e..e.e@ee@e.e@e..
w.e@@..e....e@.@eee.e@@ee@e@@e@@e..w
..@ee.....@e@...e.@e.e@e@...e.e.....
.....e@e@.e@..e.@e@e..@e@e@@ee@..e..
w.......e.....@ee@e@e.e@..ee@ee.e@.w
.........e@........e@......@.@@e....
.........ee..@e.e.ee@....e@e.ee@....
w.e@e...e@...eee@.@@e@ee@@e...@e.e.w
..@e.....e@.@e@@e@e...@ee.......e@..
..@e..e..@e.ee@ee@e..e@.........e@..
w.e...@...eee.........ee....e@..@e.w
....e.e@.e@@@e@e.eee@.e@ee@e@e......
....@e.ee..e@e@..@@@e@e@@@e..eee@...
w..e@@.@@e@ee.e..ee@ee.eee@..@@.e..w
....ee.ee.@e.......e...@e..e@eee....
...@e...@.e....ee.e@e@e........@e...
w.ee....e.@...e@@ee@@....e.e.......w
..@.......ee.e.e@@eeeee.e@.@.e@e....
..e.e@e@.e@@e@..e.@e.@@..e.e@@ee@e..
w....@ee.e.e..e...e@@eee.@..e...e@.w
.....e@@e@....@e..e@e..@.e.....e@e..
..@e...@e@....e@..e....eee@.........
w.e..eee@e...e@e..@e...e@.e..e@.e..w
..@.e@@e...e@@e@.e@e......@...ee@...
..e.e@e....@ee.ee..@..e...e@e@.@@e..
w.....e@e.e..ee@@e@e..@e@.e@ee.ee@.w
..@e..e@@e@..@ee@.....e.e.@e.e...e..
..e.ee@e..@ee..@ee..e..e@e@ee@@e@@..
w.@e@@e@..e@@e@.e@e.@.....ee@ee.ee.w
..@ee@e@e....@ee@e@@e@@ee.@ee@......
..e.e@.@e.e@..e@...e.ee@@.@ee@e@....
w.e@@e.ee..e..@e..@e@e.ee.e@e.@e...w
...ee@e@@e@e@e..e@e...e@....@e......