33,36
351
351
1000
...ee@e.@ee@.eee@@e...@e.ee@e@.e....
w..@..e.e..ee@@.ee.@e.e.e@@e.e.@e..w
...ee@@e..e...e..@.e....@e@e..@ee@..
...@@e@@ee@.e@...e...e.e.e@@e.e@.e..
w..e@ee@....ee......e@e@.@e....e@e.w
..@ee@.ee.e@@e..ee..@.@@e@@ee...@e..
..e.e.e@@.@ee@e.@@e.e.ee.e@e@...e@..
w.@.@.@.ee@@e@@ee@@e..ee....e@e.@..w
..e.e@e@.eee.e.e@ee@e@@@.@e.....e...
.....eee.@e@@ee@.e@..eee.e..........
w..e@@@..e..e@.@e@@e@e........e@@e.w
....eee@e.@e@..e.@e@e.e@e.....eee@..
...e@.@...e......ee@@e...e@@ee@@e@..
w...e@ee@ee......@.e...e@eee.e@e.e.w
....@..@ee@.e@@eee@.e@e@.....@e@.@..
..@ee.......@eee@.e.ee@..e..e@...e..
w.e.......ee.@e@..@e@@e..@e..e.....w
..e......e@@..@e..@e.e@.....e..e....
..@e...e.@@e..@e..e....e@.e.@ee@....
w.e@...@.ee..@eee.e...@ee@@.e...e@.w
......@e..@e@e.@@.@ee.e..eee@ee@.e..
...e@ee@e.e.e..ee@@e@..e..e@.@ee....
w..e@e@.@e@e@..e@ee@..e@e..ee@@e...w
...e@@ee.e@e@ee@..ee..e@@e@@eee@e@..
....ee@@@e..e@...e@@e..e.eee..@e.e..
w..e@@eee.ee.......@e..e@@.@@e...e.w
..e@@e....@@e@e....e..e.ee.ee...e@..
...@e.....e@..........@e@.e@........
w..e.......e.e@e......@e@eee.......w
..e@....e.......ee@.eeee..@@e..e@e..
........@e....ee@@e.@@.@e.e@e..e@e..
w.....e.e..e.e@e@e@.ee.@e....ee@e..w
.....e@.@e.@ee@e.......e....e@..@e..