33,36
366
366
1000
..@eee.e@e@e.e@e.e.....e.@ee........
w.ee@@e.e.@e@e..e@.e..e@.e@@.ee....w
....e@@e..e.......e@e@e.ee@ee@@ee...
.....ee...@ee...e.e@ee@.@e..@e@@@e..
w...e.@e...e@@e.@e.e@@ee@e.ee.eee@.w
..e.@e.......e@.e@e@@e.e@ee@@e.e@e..
..@e@e....@e@@e.ee@@e......eee@ee...
w.e....ee@e.e@ee@@@e@..@e..@@@ee@..w
..@eee.@e@@e@.@.eeee...e...eeee@....
..@e@@e@@ee...ee@e@@e..e..e@e@.@e...
w.e.e@@e......@.e@...@e@..ee..ee@e.w
..@e@e.@e.@e..e@...@ee...e@@ee@.e@..
..@e...e.@e....e@e.e.e@.ee@@e@e@e...
w.e..e@@ee.......e...eee@eeeeeee@e.w
.....@e@e@.....e.@e.e@ee@@e@@@@@....
...ee@e.......e@....@e@.e@..eeee....
w..@e.........e....@e...ee@e..e@...w
...@e@e....e.e@e...e....@e..e.......
...e......e@.e@@e.e.....e@@e@.......
w.......@e....e@..@.e@....e........w
......e@e.....ee@ee.@ee.....eee.....
....e@ee.....e@@e.ee@e@eee..@@@..e..
w...e@@e.e...e.e@.@ee@e@@@@eeee.e@.w
.....e@ee@@e.@..@e@...e@eee@@e..e...
...e@@e@@.e@@e..e.e...e@..eee..e@...
w.e.e...e...e.e@e@e...ee..@@@e.e@e.w
..@e..e@eee.e@e@e@...e@@..ee.e@ee@..
...e@...e@@.ee.e.ee@.e@e..@...@ee...
w..ee.e@..e.@e.....e@@eee@e@e@e.@e.w
..e@..ee....e@..e@eee.@@e.e@ee..e@..
......@e..@ee@.e@@e@..e@e.e@e@..@e..
w....e@e..e..e.e@eee...e@e.e....e..w
.........e@...e@ee@@ee@ee@..........