33,36
346
346
1000
....e@.......e....e@ee.ee..e@e..e@..
w...@e.@e..e.@e.....e@e@@e.@e....e.w
..@e@e.eeee@e@e@.e..e@ee@e.@e@.e.@..
..ee@ee.@@e@ee@ee@.e.@ee@e.eeee@.e..
w..e@e@.ee...ee@@e@@@e.e@eee@....@.w
...@e.e@e.eee@@e@eeee...e@@e@.e@.e..
..e....ee@@@e@e.e@.....e@e@@e.ee@...
w.@...e@@ee...@.........@ee@e.@.e..w
..e.@ee@......ee@.......e.ee@.e.....
..@.e@@e.e...@e@e.........@e@e@.....
w.ee@e@e@@e..e.e@...e.....@e@e.....w
...@e.eee@e.e@.@e..e@.....e.........
..e@..e@e...@eee@.e@.@e@e...........
w..e@e.e@e...e@@e@@e@e@e...@e@e....w
..e...e@.@.e@e.e.e...e.@e..e........
..@ee.@@eee@@ee......@ee@..@e..e....
w.e.@@ee@@e.e.@..e@e@e@@..ee...@.e.w
..@@ee.e@@e...e..e@@e..e.e@@...ee@..
..ee.e@eee@e......e.e..@.e.e@e@eee..
w........e@@ee......@e@e.@e...e@@@.w
..e@e.....e@e@e......@e@e@e.....ee..
..e@e......e@e@@e..e.eee@@e......e..
w.e@eee......e@e@..@e@@..e....e@e@.w
..e@@@@e.ee@.@e.e@e@e.e@ee....@e....
...eee@ee@.ee@..@ee@..@ee@@e@e...e..
w.e...e@@e@e@ee@e..e..e@.@e.....e@.w
..@@e.@e@ee@@e.ee@.e@eee@e@.....@...
..eeee@e..e@ee@@ee....@........@e...
w...@e.....@e@e.......e.e@...e@e@..w
....e@e....e@e@..@e......e...@e.....
......@e..@eee...eee.....@..........
w.........ee@@....@@e.ee@e.e.e@ee@.w
.........e@..e....e@e.@e..e@..e@.e..