33,36
356
356
1000
..@e....e@@ee......e@@e...e@..e.....
w.e.....@ee@@......@ee..e@@e.e@....w
.....e@e@eeee@ee@e..ee...ee.ee@e....
...e.@e.@e@@ee@@e.ee@@e...@e@@e.....
w..@..e@e@....e@@e@@e@@e....e@@e@e.w
...e..e.......@ee@.e.e..e@e.eee@e@..
.....e@@e.e@e@e.e...e@e@e@e.@@.@e...
w..e...e.e@e.e@e@e..e@ee@@eeee.e...w
..e@.....@e......@e.@@ee@e@@e@.e....
.....e..e@......e@.eee.ee.ee@.e@.e..
w..e@@e@ee...e@e.e.@e..@@e@...e@e@.w
...@e@@e.....e@e....e@eee@@ee..ee...
..e..e.@ee..e@@e.........ee@@e.e@...
w.@....e@@@e..e@e@@e....e@e@e@e@e..w
..ee@e.e@ee.ee...eee@e@.@e...e@e@...
...e@ee@e@@.@@e..ee...e...e.@eee@e..
w..e@@e@eee@ee@.e@@@e.....@eee@@e..w
...@ee..e@e..@ee@.eee...e@e@..e@....
...ee@..e@@.e@@@e@ee@@eee@..e@.e@e..
w..@.....ee.eee.e@e..e@@.e@e@ee@...w
...e...e.e@.@e..e@e@ee@e.....e......
..e@...@...e@e..@e@.....ee..e@..e@..
w....@ee.@e.e@.........e@@ee@....e.w
.....e@e.e..@e..ee......e@e..ee.....
......e@..e@e..e@@...e@.....e@@.....
w.@e......e@e..e@e@@e.e.ee..e@e@e..w
..e.e.....e...ee@.ee@.e.@@e.@e......
....@.....@e..@ee....e@.e...........
w...e..e@e@eee@e...@e...e..e.......w
..e@e...e@ee@@@e...e...e@.e@..@e@e..
..@e@..ee@@@@ee.....e@ee@...e@e..e..
w....ee@.eeee..e....@@e.e@e@@@eee@.w
....e@@e....@ee@....ee.....eeee@.e..