33,36
354
354
1000
...............e@..e......e@.e@e....
w.@e.....@ee@e..ee.@e@ee.e.e@ee@e..w
..e@.e@e.eee@e...@ee@ee@.@e@...e@...
...e.ee@ee@e@......@e......e@ee.ee..
w.e@.@@.e@e@e....e@e...e..e@..@e@@.w
..e@eee..ee...e..@ee...@...e..e.@e..
..e@e...e@@e@e@....@...e...@e...e...
w.@.@...e@@ee.@e...e.e........e.e..w
..eeee..@ee.@.e@.....@e...@e..@e@e..
...@e@e@....e@.e@e@ee@e...e@e...e@..
w..e@.@ee.e@ee...e@ee@@e.e.e@..e...w
...@.e@e@.@e@....@...e@.e@e....@e...
...e....ee.e@.e.ee....ee@@ee...e@...
w..@....@@eee.@.@e.....e@e@@...@ee.w
...e.e..e@e@@ee@....e@e@...e...e@@..
.....@ee@ee@...e...e..e....e...@.e..
w......e@@eee......@e@@ee..@e..e@..w
..e...eee@ee@...@e@e.ee@@e...e..e...
..@...@@e@.@@e..e@.e@@@e.ee..@.@e...
w.e...ee.e.ee..e...@eee@.@@eeeee...w
........@e@e.e.@e........ee@@e@e....
........e@..e@e@e..@e...e@e@e@e@@e..
w..e...e@@e@@e@.e@.ee@e.@@ee.@e.e..w
..e@e..eee.e@e..@e@e@@e.ee@..ee@e...
...e@..@@e....e@e.e..e.ee@e@e...e...
w..e@e.e.e....@...@.e@e@...e@e@e@..w
........e@@e.@e.e.e.@e@.@e@@...@@e..
.........@e..e@.@e.ee..ee@ee...eee..
w.e@ee.e@ee@e..e@e@@e.e@.e@....e@@.w
..@ee@.e@ee@ee...@e@eee.e@.....@.e..
...@.@ee@.e@e@.e...@e@@.@e.....ee...
w..e.e..ee@e.ee@e.ee.@e...e..e@.@e.w
..e@e@...@e..@ee@.@e@ee@e.@e@ee.e@..