33,36
360
360
1000
..e@e@e..@e...e@e@.e..@ee@e...e@ee..
w....@e..e@...e@ee.@eee.e@e.ee@..@.w
.....e...@.....@ee.ee@.e....@e.e@e..
..e@e..e@e...e.e@@e@@ee@@e....ee....
w..@e@.....@e@...e....e@e..e.e@@e..w
..ee.ee..e.e@......@e@..@e.@e@e@e...
..@e..@e.@e@....@e.e.ee.e@e...e@e...
w....ee..e.ee.eee.e@..@ee@@e...e@..w
....e@@e@@e@@e@@e.....@e@e..@e......
...@e@eee..@ee@e@@e@e@e.@e..e.e@.e..
w..e..e@e.@e.e@..e.e@.e.e..ee.@ee@.w
...@e.ee@.e@e.ee@e@e..@e@e@@@e@e....
.....e@@e.@e@e@@..ee......eee@.@.e..
w....e@e...e@e@e.e@@@e.e..e....e.@.w
.....@.e..ee..e@.e@ee.e@..@e...@ee..
.....e.@@e@@e@e..e@e..ee@e.@e.e@e@..
w....e@eee@e.e.@e.@e.e@@e.....e@e..w
.....e@e@@e@.@ee..ee..e@e.....e@....
.....@e..e...@e@e@e@.e.e@......e....
w.e........@ee.eeee@e@.e@e...e.....w
..@e..e@e.ee@@e@@ee@...@e@...@e.....
......@...@e.eee@e.ee.e@eeee..e.e...
w.....e.....ee@@e@..@.e@e@@@ee@e@..w
..e@e.e@e...@@.e..@ee....@e....e@e..
..@e..@ee..eee....e..e@e@e.e@e@e....
w.....e@@e.@e@.e......e@@ee@e..e@..w
...ee.ee@@ee@.e@...@e...e.@e@e.@e@..
...@@e@.e..@e.@e...ee.ee.e@ee@ee.e..
w..ee@...@ee.......@@.@@e@e..e@@e..w
....e@e..ee@....e@eee.ee..@ee@@ee@..
........e..........e@...e@@e@.e..e..
w.......@eee....e@e...ee.eee@e.e@..w
.........e@@e@e..e@..e@@e@e@....e...