33,36
354
354
1000
......e@e....e@e.e@ee@e@e.....@e.e..
w.....@e.....@e@@e...e....e...e..@.w
..........e@ee..eee.e...ee@.@e.e.e..
..e@.....ee@..e@@@@e@.e.@e@ee..@e...
w.@e...ee@.e@..eee..@e@.e@....e@@e.w
.......@.ee.e@e.....e@....@ee.@e....
..e.e.@e.@@e........e@.e@ee@@e......
w.@e@.ee.e@e.e@e....@e...e@@e@...e.w
..e@..e@.e@@..e@..e.e..eee@e.e...@..
.......e..ee.....e@.@e@@@.eee@...e..
w.....e@e@e@.e@e.e..e.eeee@@e......w
.....e@.......@ee@..@e...@e..e..@e..
....e@@e..e...eee@e........e@@e.e...
w....@ee..@e...@e@.........@e.@e...w
.....e@@ee@e@ee@.e.......ee@e@e@....
.....e@e@.e..e@e....ee@e@@e..e.e@e..
w.ee@e@.@e...@e....e@@..e.....e@...w
..@@e.e.e.@e...e@e@e@e.e...@e.e@....
..e@e@..@ee@....e.e.e@.@...e.@eee...
w..e.e@e@@e.....@e@e@e.ee@ee.e..@e.w
...ee.e@e..........@.@.@e..@e@...e..
..e@@e@ee.......@e@e.ee@@e@ee.e.e@..
w....@e@@e...e@.ee@@.@ee@e@e@.@ee@.w
....e.e@@e@ee.ee@eee..@e@@ee@e@@@e..
....@e.eee@@@e...@.e@ee.e@eee@ee....
w......e.@ee..e..e@ee@.@e@e@@.@e.e.w
...e...@e.@e..@ee..@@e.e.e..eee@.@..
...@eee..ee@..e@@..e.....@...@@..e..
w.e.e@@e.@e.ee..e....ee..e...ee....w
..@ee@.ee@.e@@e....e@@@e..e.e@e@ee..
..e@.ee@.e..e@...e@.ee@@..@.e@e@e@..
w.ee@.e@.@ee.ee@e.ee@.eeeee@ee@e@e.w
..@ee..e.e@@e.@e.....e@e@@ee@.......