33,36
364
364
1000
.....e..e.e@e.ee@ee@...@e..e.e@@ee..
w..e.@ee@@e..e@.e..e.e@e.e@@e.ee.@.w
...@ee@e@e...@ee@@e..e@...e..ee@.e..
..@e.e@@@e...e@..e....ee..@ee@e@e@..
w.e.e@eeeee.......e@ee@@eee.e@@e.e.w
...e@@ee@@@.......@ee@e@e@@@eee@.@..
...e@e.e@ee@....e@..e..@e.ee..@e@e..
w.e@...@e.@ee..@ee.e@..e...e@e..@e.w
..e@ee.@e@e.@e.e.@e@......e@@e@ee...
..e@e@.e..ee@e.@.e.eee@..e..ee@e@...
w..e@..e..@@ee@e@.e@@@e..@e@.@.@e..w
.......@e.e@e@..e..@e.@....e.e..@...
..e.e.e@.ee@e...e.@ee@ee@.......e...
w.@e@..ee@e.....@.e.....e....e.e...w
...e......@e@...e..ee@e.....e@.@e@..
..e@.e@e.e@.e..e@ee@.@e.e@e.@e@eee..
w.e@e.....e.@ee@e.@.ee..e@e@e..@@e.w
..@e@...e@.e@e@@e@ee@..e@....e@e@e..
....e..e.e..e.eee@e..ee@...ee@@e.e..
w...@ee@e@...e@..@eee@e@e@e@..e@e@.w
..e.ee@@e..e..@e.e@@e..e@ee@e.@e....
..@e@..e.ee@e.e...e@...@......@ee...
w..e..e..@e@@e..e@ee..@e......ee@e.w
...@.e@e..@e@e.....@..e....@e...e@..
..@e.@e..e@....e...e.e@..e@e....@...
w.ee.e@e..e...e@........e@.@e@@ee..w
..@@e.e@@e.....@ee@e.....e.e@ee.@...
..e..e@ee.e@e..e......e..@e@e...e...
w..e@@@ee....e.ee....e@@e..e@e.....w
...@eee@@..e.@e@@e.....e..e@.e......
..e.e@.ee.e@e@..........e.@@e@......
w.@e...@ee@@ee.e@e.e..e@@.ee..e.e..w
..ee@e.....e.@ee@ee@..@ee....e@e@e..