33,36
358
358
1000
..@e.ee@e@..e@@e....@ee@e..ee@e@e@..
w.e@e@@..e...ee....ee..@ee.@.@ee.e.w
....e.e@e@..e....ee@..ee@@ee.e@..e..
...e@.e@e@..@ee.e@..@e@..@e....ee@..
w....e@e@e.ee@@ee...e.e@ee..e..@ee.w
...........@e@@e@.e...@e...e@...e@..
..e@e.@e..e@@eee..@.........ee.e@...
w.@e..e...ee.@e@@eeee.......@@ee@e.w
..ee@@e..e@@ee@.ee@@@@e.....e.......
..@eee...e@.e@..@..eee.e...@e.ee....
w........@e...e.ee..@e.@...e@e@@e..w
......@ee.....@..@e....e.....e@@ee..
..e...e.@@e...eee......ee.e@..eee@..
w.@@e...eee...e@@.@e.ee@@e@e...@...w
..ee...e@e@e.e@.e.e..@e..@e...@e....
...@...@e..@e....@e.ee..e.@...ee@e..
w..e..e...e@@e@e@e@e@@e.@.e@ee@@e..w
.....e@.e@eee@@e@ee@.e@ee.e.@@e.....
..ee@e..e@e@..e@@e@e...@e.@ee@e.....
w.@@e@.....e@@e.ee@@e@e@e.e@@.e@e..w
..e.e@e.e@.eee...eee@.......e.@e@...
..@e.....ee@.e.ee@@@e....e@.@e.e@e..
w.e@...e@.e@e@e@@ee@e.....e...e....w
..e.....ee@ee@@ee@.e@.....e...@.....
..@e.e@@e@...e.ee@e@..e@e.@...e@e@..
w.ee@.ee@ee....@e@ee..@ee.e..@ee@e.w
..@ee.eee@@..ee@.ee@.e@@@....e..ee..
..e@@.@@eeee@@@ee@.@e.eee......e@@..
w...e@e..@e@ee..@@eee@e...ee...e.e.w
....e@..e@e.....ee...e@..e@@@e.@e...
..e..e..e@@eee@e@....e@e.@eee.e@....
w.@e..@e.e@@@.............@e.e.e...w
......e...eee.......e@e....@e@.@e...