33,36
353
353
1000
......e@e...e@..ee@@ee...e@e@...e@..
w.e.@ee.....@e@e@.eee@...@e.ee...e.w
..@ee@@e........e.@e@e.e@@e@e@..e...
..e@............@.e@....ee@.....@...
w.e@ee.....e@e..e.e@e.....@e....ee.w
..e@e@..e....e....e@@e..e@e..ee.e@..
..e...e@@e@ee@ee...e@e@.e.@e.@@.e@..
w.@e...e@.....@@e@....e.@ee@eee..e.w
..e@...@e.....eeeee@e.@e....@.e@....
.........@e.e..@@e....e@e...e..ee@..
w.e@e....e..@..ee...ee@@e.e@e.e@ee.w
..@e@...ee..e..e@...@..e..e@@e@.....
..ee...e@@....e@e@..ee@ee..e..e@....
w.@@e.e..e..ee@..e.e@.e@@e...e.e...w
..e@e@@e....@e@ee@.@e...@e...@......
..ee.e..e@e@.e@ee@e@eee.e@.e.e@.e...
w.@..@.ee..e....@ee@@@@e..e@.eee@..w
..ee@ee@@e@e@....@@eee.....@e@@@e...
.....e@e@@e@ee@..e@e@......e.ee.@e..
w.e..@@ee@..@@e..@e@@e.e..e..@.e@@.w
..@..ee@.e@.e....e..e.e@..@eee..ee..
..e......@e...e@e...@ee.e.@e@.e.....
w.e.....e@e..ee@..e.@e@.@ee..e@....w
..@.....e@@..@eeee@.ee@ee@e@e@@e....
..e...e@eeee.e@e@@@e....e@@e..e.....
w......e..e@e@.@@ee.e.e..e..e@.....w
..e@e.e@e@@e...ee@.e@e@.....@e@e....
..e@ee.@ee@e@....e..e@e@eee@ee@@e@..
w..@e@.e@.@ee@e..@ee@@e..@ee@.e..e.w
...ee@....e.e@@e.e@..ee.....e@ee@e..
...@.e......@e...e@ee@@e....e@e.....
w.ee.@ee@ee.@eee.e@....@e.@ee@e....w
..@e....e@@eee@@e@e.e@ee@.e@........