33,36
364
364
1000
..e....e@ee.e@@e..@e..e@e@.ee@e.e@..
w.@..e..e@@e.ee..@e@.@eeee.@e....e.w
..e..@e@e@e....e@e.e.eee@.e@e.......
.....e...e...e.@e..@ee@...e@e.......
w.....e..@e.e@....e@e..e...@e@e.e..w
..e@..@e..e@.@e...e@e..@ee@ee@@e@...
...e......@e.e..ee.@e.e@e....eee@e..
w...e........e.e@@eee@e@@..e.@e.e@.w
....@ee@e..e.@..@e...e@ee..@e..e@...
....e@ee@..@.e..e@.....@...e@...e@..
w.....@e@e.e...e@@e.e..e...@@e...e.w
........e@.......e.e@..e@e.eeee.....
..eeee......e@e.e@@e@e.e@e..e@@ee...
w.@@@@.e@...@e...@e.e@.ee@@e...@@e.w
..eeee..ee...@e..e.e@e.@e@e@.e.e....
..@e.e@e@@ee..@e...@@eee.ee.e@e.....
w.@e@e.....@.e@...eee@@..@@eee@.e..w
..e..@....@e.eee.e@...e..ee@@ee.@e..
..e@@ee@e.e@e@e@.e.....e..e@ee@e....
w..ee@e......@e.e@..@ee@..ee@@e..e.w
..@e@.@..e...e..@e..e....e@@e@eee@..
..eee.e..@...eee@e.e....e@e@e@e@....
w.@@@e..@e@e.@@.@e.@e...@e..e@ee...w
..eee...e.e@.eeeee@....e@e@e.e.@.e..
..e@@e.e..@@e.@@.@e@...ee@ee.@ee.@..
w.@e@e.@e@eee@ee.e.e@e.@@e@@e@@..e.w
..e..@e@e@e@.....@.e@eeee..e@eee@e..
.....e@e.........e.e@@@e...@@e.e@...
w..e..e@.e@....@ee..ee@e...ee@e.ee.w
..e@..@@e@ee...e@@e....e@e..e.@e@@..
...e..ee..e@e..ee.@..e.@....@e@e.e..
w.e@...@e.e@@..@@.e@e@.ee....@e@...w
......e@e..ee@eee@e@e..e@...e@e.....