33,36
347
347
1000
..@ee@@e..eee@@ee.ee.e@e......e@@e..
w.e.@ee...@@.ee@@e@@@e...e@.e..eee.w
..e.....e@ee.e@.e@.ee.....ee@@e.e@..
..@.e@e.e@e.e@@e...@..e@e.e@ee@..e..
w.e..e@.......e@...e@.....@@ee@.e@.w
...@e@..ee..........ee....eee.e.....
...ee..e@@e...ee..e@.@ee..e.@.e.....
w..@@e@e@e@..e@@e@eee@@@.e@@ee@....w
..@e@e@ee..e....@e@..eee.e@e@@e@....
..ee@.e@..e@@e@@e....e@..e@ee@.e@e..
w.@eee@@e..ee@eee...e@@ee@..@e.e.e.w
.....e@ee..@@...@e.e.@e..@e@e.e@.@..
......ee@e.ee@....e@.e.e@ee@@ee@ee..
w....e@@e.e@@ee.......e@..ee..e@@..w
...e..e@e.@...@e@ee@e...e@@ee@.ee...
...@eee@e.e.....@e.e@e.e.ee@.eee@...
w..@e@@e....e@e.e@e@e@.@.e.@ee@....w
...ee@e...e.e@e.....e@ee.@ee..e.....
..e@@@e.e.@e..ee.@eee@e@e@e@..@.e@..
w.@.ee..@.@e.e@@eee@......e@e.e.@e.w
..e.....e.e@.e@e@.e@e.......@e......
..@e.e........e..e@ee...............
w.e@.@@e@e@...e@e@.e@..e@e...e.....w
.....ee@e@e.e@e@....e..e@....@e@e...
..e@.@@..@ee@e.eeee@@e.@e.e@ee...e..
w..e.eee@ee@e@e@@@.e@@e@e...e@.@e@.w
..e@.........e@.ee..e......e@e.e....
...............e@...e.....e@e@......
w.e@e@e......e@e@e@e@..............w
..@..e@e@.........e@e@e.....e@......
..e.e@@ee....e@e.@e.e@e...e@ee@e@...
w...@ee@@....e@@.ee@@e........e@e..w
.....@e.ee@e..ee.@ee@e..........@e..