33,36
357
357
1000
..e@@e@e@e.e@@e..e......e@e@..e@e@..
w..ee..e@e@eee.ee@..@eee@e.e.e@e.e.w
....@ee@e......@....ee@@e..@e@@e.@..
....e@e@@e.....e.e.e@@@e@e@ee@e.ee..
w.....@ee@.......@.@eee.e@....@.@e.w
.........@e.e...ee.e....@ee@..ee@...
..ee@e.e@e..@..e@..@e.....@e....ee..
w.@ee@e@.e@ee.....@e@e...e@e@.@e.@.w
......@e....e@....e..@e@e@@ee.e..e..
....e.e....e@ee..e.....e..e...@e@...
w.e.@.@....e@.@e@@e@....e.e.....e..w
..@.e@e....ee...e.@e.e@e@e@@ee@e....
..e.ee....e@.....e@e..e.@e.e.e@@....
w..e@@e.......ee...@e...e@.e..ee.e.w
...e@e...ee..e@@....@@e....@@e...@..
....e@e@e@@..e@eeee@ee..e.@eee@e.e..
w.....@e.@e.e@@e@@e@e@..@eee...e@e.w
..ee.e@..ee@e@e@@ee@e...e.e@ee.@ee..
..@@..e.........ee.....e@e@e@@eee@..
w.ee......e@.e@.e@.......e@ee@@@ee.w
........e@@e.ee..@ee..ee.e@@eee..@..
........@e..e@...e@@.e@@e@e@e....e..
w..e@...e@..@..e@e.e@.eee....e@e...w
....eee.e@..e@e@....ee@@@..e@..@....
...e@@@e.e.e@.ee@e.@ee.eee..ee@e@e..
w...eee@@e.@ee@@@e.e.@ee.@eee@ee...w
..e@@ee.e@...e@ee.ee...@e..@@ee@....
...ee@@e..ee...@ee@@eee@@..ee@e@e...
w...@@eeee@@......e@e@.ee..e@ee@e..w
....ee.@@@@e....e@e@e@e.e@e@e@......
..e....eeee...ee@e@@e@..@e@..e@e@e..
w.@.......@ee.@e@e@e.ee.........e@.w
..e.......e@@ee@e....e@.............