33,36
367
367
1000
....@e.......e...e@.e@e@e..e@e@ee@..
w...e.e...e.e@...ee..e.e..@ee....e.w
.....e@.e.@e...e.@e@e.e@e@e......e..
......@e@e@e..e@.ee@@..e@@e.....e@..
w...e.e@@e.......eeee..e@ee....e@e.w
...e@e@ee....e@..@@@e..@ee@.....@e..
...@.@e@...e@ee.@ee.e@e@.......ee...
w..e....e.e...e.e...@e.e@e....e@...w
..e.@e@.@e@...@e@............e@e....
..@ee.e.e@e...@e.e@.e..e@e.e@@@e....
w...@.ee@e.e@.ee@.e.@e.e@@..eee@e@.w
..e@ee@@@eeee..ee.@e..@eee...ee@ee..
..ee.@@ee.@@@ee@..@ee.e..@e@e@@ee@..
w.@@eee.e.ee..e@..ee@.......e@e.@e.w
..e.....@e@.ee.e....@e..e@..@...e...
.......e@@.e@@e....ee..e.e..e....e..
w..e@e..ee.@@e@....@e..@eee@ee..e@.w
.......eee.ee..........@e@@ee@......
..e..e@@@@e@.....e@....ee@e@@e.e....
w.@e..eee@e@e.@e@ee...e@e@e..ee@ee.w
....ee@ee@e...e@@e@.@e.....e.@e@@@..
...e@@eee@ee@e@ee...e...e@e@e.eeee..
w.e@e@.@e@@e..e@@e@e@ee.@ee@@e@@e@.w
..@.ee...e.@e@e@e.ee@@@@e..e..ee....
..e.@@..@ee@ee.e@.e.eeee.@e.ee@@....
w...ee..e..@e.e@e.@e@@e@ee.e@.eee..w
........e..e..e.@e@e@e..@eee..@.@e..
...e@e.e@e...e@...e@@e...e@@..e.@e..
w.e....@e@@e.@ee...@e@ee@e@e.e@.ee.w
..@e..e@eee...@@@eee.e@@e@.......@..
...e...e.@@.@eeee@@e.e@e.........e..
w..@e@e@.ee.ee@@e.e...e@e...e......w
.....e..e@@e@....e@.....@e.e@e@e....