33,36
358
358
1000
..eee@ee@e@@e@e..e@e..e@e@...e.e.e..
w.@@...ee.ee.e.........@eee@e@e@.@.w
..ee...@.e...@..e.eeee@ee.@ee@.e.e..
..@ee..ee@e..e@.@e@@@e.e@....e.@....
w.e@@e.e@@e@e@ee@e.e@e...e@e.@@e@..w
.....@...ee@@eee@......e@e.@eee.e...
...e.e....@ee@@ee...................
w..@.e.......ee..........e.e@e.....w
...e@@.e.e..e@@e@e...e@..@ee@@e.e...
...@ee.@e@..e@e.......e...@@ee@e@...
w....@ee....@e.e.@ee..@.e@e.e@@e@..w
.....e@.....e@.@ee.@..e...@.@@e.e...
....e@e@e........@ee...ee@e.ee......
w.....e@.e...@e..e@...e@e...e@.....w
......@e.@ee.e.@e@@e.ee@@...ee.e....
....e...@ee@e@.e..e..@.ee.ee@e@@@e..
w.@e@...ee@@e...e....e...e@..@eee..w
..e@ee..@.@e.@ee@.e...@e@e.ee.e@@...
....@@e.eee..e@e@e@..eee@.e@@e@.e...
w.eeee.e@@@ee..e...@e@.@e@e@e@@e...w
..@@e@...ee@@e.@eeee@e...e.ee@e.e...
..e@e@.@e@@e@@..@@@e.@.e...e.e@.@...
w.ee.e.e.e@.ee@eee...e.@.ee@.e@eee.w
..@e.eee@.ee.e....e@.e@e.@e@e...e@..
..e@e@@@e.e@e@.....ee.e@.e..@@e.e@..
w.....e...e@..@e....@e@e.@..ee...e.w
...e.@ee..ee..e.......e@.e......@e..
...@ee@@e.@.....ee....@e.e......e...
w.e@@.....ee@e@e@@e...e@.@@e@e@.@e.w
..@eee@.ee@@ee@e...e@e@e@eeee.e.....
....@eee@@e...e...@e@e..e@e@...e@e..
w..ee....e@e..@ee@ee..e......e@@e..w
..e@@e....e@....@e.@ee@e@ee@e.ee@...