33,36
366
366
1000
..e@e.e....e@e@...e@....e@e....e@...
w.....@e....@ee.@eee.e.@e@.....ee..w
.....e@e.@e.e@..e@@e@@ee.e..e@e@e@..
.....e@e.e.......e@ee@.......e@e@e..
w.e..e@.....ee...@e.@eee@e.e@e.e@..w
..@@e@e.e...@@e....e@e@...@e@e@ee...
..ee@...@@e.ee@.e...e@e@e.ee@@@e....
w.......ee..@ee@@e....e.e@..eee....w
.......ee@.e...e@.e@ee@..e..@..e@e..
..e@e.e@@@e@....e.e...@ee@..e.......
w....e.@ee@..eee.e@e.eee@e@e.....e.w
..e@.@.e....e@@@ee@@e@....@e.e@@e@..
..@e.ee@......e..@ee@..e@.e...eee@..
w.e...e@ee.e......e@..@ee........e.w
..@......@e@...e@e....e@....eee.....
..ee@@e.eee@e....e...e.....e@@@e....
w.eeee.e@@e.@..e.@...@......@e@e...w
..@@e..@e...e..@.e..ee.e@...e.@ee...
..e.@e@e@..e@@eee@ee@...e@e@..e.@e..
w..e@@e...e..e.e@@e.e@..e@ee.e@@e@.w
....e...e@@e..e@@e...e@e..@@e..eee..
.........e.e@ee@e...e@@eeee...ee@@..
w.e@e@.....e@e.....e@@ee@@@e@e@@ee.w
..ee.e..ee..e@ee.....e@.@e@ee.......
..@@ee.e@@ee.e@@e@e@e...ee.e.e@ee...
w.ee@@e@@ee@ee@@e..e@...e@.@e.e@@e.w
.......ee.@.e.eee.ee@e.e@eeee..@e@..
...e@ee@..e.@e.@@e@@e@.@@e@@@..ee@..
w...e.@ee@@e@..ee..ee@eee..ee@e.@e.w
....@e...ee.e.e.@eeee...@e..@...@e..
.....ee@.@@e..@e@e@@@..e@e@eee@ee...
w.e.e@.e.e..e@e....ee.....e.e@@e...w
..@e..e@.@e.e@e@e......e@e@.e@e.....