33,36
343
343
1000
..e@e@e..e@e@e@e.ee@e...e@e...@e@e..
w.ee.....@ee@.e@e@@ee@e@e@ee..ee@e.w
..@@e@e..e@.ee@.e....e@@ee@@eee.@e..
..e.@e........@e@e.....e.e@e.@@@e...
w....@e..ee@e.ee@@e@...e@e@@.eee...w
...ee...e@@e..@@ee.e.e..e@ee.@e.....
..e@@@e.@e@...e.e..@e@.e@e..e@@.....
w.e@ee..@ee.@ee@@....@e@e...@ee@e..w
...@e...ee..e..ee....e..@e@..e.ee...
..@e@.e..@.e..e@..e@.ee.e@e@e@e@@...
w.e...@e@e.@..@e.@ee.@@e...e@e@@e..w
......ee@e@e@e@e.e@..e@e.e@e@eee....
......@e@e@ee@ee.......e.@e.@e@.....
w.e...e.@e@.e@@@...ee..@e.e@e..@e..w
..@e@...e.e..eee..e@@...@ee@e..e....
..@eee..ee@.........e@e@ee@@e.......
w.e@e@.e@.....@e.e@..eee@@ee....e..w
..e..@e.......e...e@..@@...@....@...
..@e@ee...@e.......ee@eee@ee....e...
w....e@..ee.@e.e...e.@e..@e........w
..e......@e.e@e@..e@.e...e....e@e...
..@e@e..e@e@@.@e.e@@e@.e@@..ee......
w...e@e@@e@ee......e@..eee@.@@.....w
..ee@e.e.e@@@e@..e@ee@e@..e@ee......
..@e@@e@..ee..e......e.@e.@e@.@e.e..
w...e@e@e......e.....@ee..e...e.e@.w
...e.@ee@......@...e@e@.e@e.....@e..
...@ee.e@ee.e..e.@ee@e..e@e@e...e...
w......@ee@e@e@@ee@ee...@ee@..e@@e.w
..e@e........@e@@@e@@.....@e..ee@e..
..........@e.e.eee..e...e@@e.e@.@e..
w.....e@e.e@e@........e@@ee@e...ee.w
.......e@...@e.........e...e@...e@..