33,36
360
360
1000
...e@e...e@....e@..@e...e@e.ee@e@e..
w....@e..@e.....e..e...e@@e.@e@e...w
.....e....e@e.e@e.....@e.e..@e......
.....@@e..e...e@ee..e@e@eee@e.......
w....ee..e@.@ee@e@@e..e@.@e.e@e....w
..e@e.@.e.e.e.e@e.e@@e.e.e@@e@e.....
....@eee@.@e.e@e.e@.e@..e@ee.e...e..
w.ee@...e..@ee@@ee@.e@e@e.@ee@.e.@.w
..@.e@e@@ee@.@e@e.e.e@e.e@e.@ee@.e..
..e..@ee@@.e..e@....e@e.@e.e@e...e..
w.@e.e@.ee..@e.eee.............@e@.w
...@ee@@e.e@e@.e@@e.e.e@ee@e...e@...
......ee..e@e..ee@ee@e@e@e@.e..ee...
w..eee....e@eee@...e@@e...ee@@e@@e.w
..e@@@e.....e@@e....e@@ee@@@ee@.e@..
..@ee.e@@e@.e@e.@e@e.e...ee@e...@e..
w.@e...eeee..e@ee@...e@e...e.....e.w
..ee...e@@e.e@e@@...e@..e@e@....e@..
...@e...e@ee@...e.@e@.e.@.e@e...e@..
w.ee..ee.@e.e.....e@@e@.e.......@e.w
..@@.e@@ee.e@@e@e...e.@ee......e@e..
..ee..e......e........e@@e.....e@...
w.@@ee@......@e.e.e@...e@@...e@eee.w
..ee@e.eee@eee..@e.e....ee...@@e@@..
....e@e@@e..@@e..@e@....@@e..ee..e..
w.e.e@e@e@.ee.e@e..e..e@e...e@..e@.w
..@e@..e..e@....@.e@............ee..
..@e@ee.........e.@e.e@....e@..e@@..
w.ee@@@e.....e@e..e@@ee.....ee...e.w
..@eeee@@e@e.@.@...@eeee@e@ee@..ee..
.....@..ee.e.e@e...e.@@.ee@e...e@@..
w...@ee@e@e@.......@.eee@.@e.ee..e.w
....e..e@.@e.......e.e@...e.e@@e....