33,36
357
357
1000
...e@e.e@e..e@e........e@e.@e...e@..
w.e@e@e@e@ee@@e..ee@ee@@e@.e....@e.w
...@e...e@@e.e@e@@@@e@e@e....e......
...e@....e.@e...eeee.e.e..e@e@...e..
w.e.....e@e@ee.@eee@e@.@e.e@e...e@.w
..@e....e@@ee@eee@@e@@e.ee......e@..
..@ee@...ee.@e..e@@e.e..@@e@...eee..
w.e..e@...@e@....ee.e@..ee.e..e@@e.w
..e...e..e@ee@e.........@@....e..@..
..@e@e.e.@e.@e....e@..e@ee..ee@@ee..
w...e@.@e@.........e..@@e..e@.ee.e.w
....e@e@ee..@eee...@eeee.....e@ee@..
..e.e@e....eee@@ee.e@@e@.e...@ee....
w.@ee@e....@@ee@@@e..e@..@.....@e..w
...@@@e..@eee@.ee...e.@eeee...e@....
...eee...e..e..@..ee@.e.@e@....e....
w.@e.....eee@..ee.@..e@.ee@e.e@e...w
..e.e....@@e..e@@ee..e@e.....e......
...e@....e@ee@ee@e.ee@e@.e@e.@e@....
w..@e....@e@e...@e.@e...e@...e@e...w
...e@e@..ee@@e.@e@e@e..e@...........
...@..e@e@.e..ee...@eee.e@e@e..eee..
w..e@e.e@e@eee@....e@@@e.e@...e@@@.w
..@e.e......@@e@e@..ee@ee@....@@ee..
..e.e@@e@e..e....e@e@..@e....eee....
w.e@e@e...ee@e..e@.e@ee.e.@e.@.....w
..@ee....e@@ee....e@@e@.@.e..e@.....
...e@e@ee@.e@@e...e.e@.ee....@e.....
w...@e@ee..e@e....@e@e.@e.@ee@ee@e.w
....e@@e@.......e@e..@e@..e.....e@..
....@@e@ee@e@...@ee@ee@e...e@e......
w...ee.e@...e..e@e...@e.e...@e.e@..w
..e@e.e@e...@e.......e@.@e..e..@e...