33,36
359
359
1000
....@e..e@@e@ee@@ee@eee@e@@e.e@e....
w...e..e@eee@e.ee....@e@eee@.e@e...w
..e@...@e@e.e@......e@e@..e@e@@e....
...e@e.e.e@..e..e@.e@.@ee...e@e.....
w...@e@e@e@ee@..@e.e...@@...e@ee@e.w
....e..e@ee@@e..e@.@@e.ee.e@e....e..
......e@@ee@e.e@e.eee..@@e@@e....@..
w.....e.e.e@e....e@@.eeeee@e..ee@e.w
......@ee@@e@..@e@.e.@@e@...e@@e.e..
...e..e@@eee@e@ee@eeee@e.@e..e...@..
w..@e.@e@e@......e@@@....e...@...e.w
......e..e@e@e....@ee....e...e...@..
......ee..e@e.....e......@e@.eee.e..
w...ee@@....@.@e..@.e@e.e@ee@@@@e..w
...e@.@e....eee.e@e...@ee@e.eee.....
..eee.e.@e..e@@e@...ee@ee.e...@.e...
w.@@@e..e.e@@@e@....@e@e@e@.e@e.@e.w
..ee@...e@eeee............e..e......
..e.ee..@.@e...e...e@e..e.@e@@ee....
w.@e@@e.e......@e.@ee@..@ee.e.@@e@.w
..e.e@@e@e....e@e@e.........e.e..e..
..@.ee.e@@e..ee.....ee@@ee@e@.......
w.ee@..@e.@e.@@e.ee.@@ee@.e@e......w
..@e......e@.e@ee@@ee.....@e@e@e@e..
.........e.e@@e....e.e...e..e.e.ee..
w......e@@e@e.....e@e@e@e@.e@eee@@.w
..@e....e@eee@e..e@ee@e@@ee.e@@..e..
..e...@e.e@@@e.e.e@@e..e.e@...e.....
w.e@..e..e@e..e@e.e@e...e.....@....w
..@eee...@ee...e@..e...e@@e...ee....
..ee@@...e@@e.e.e@.@...e@e.....@e@..
w.@e@e...e@e@e@eeeee.......e....ee.w
....e@e@e.e..@ee@e@@e.....e@....@e..