33,36
367
367
1000
....e..e@e.........e..e.e@@e.e......
w.e@@e.e@e.ee.e@e..@e@@@eeeee@.....w
...e@..@..e@@.....ee@eee.e@@e@e..e..
...@e.ee..e@e....e@@.....e@e.@e..@..
w...@e@e.e@.....e@.ee@ee.e@.ee@eee.w
...e@e.@e@...@ee@@ee@..@..e@@e@@@e..
...@e@.e@....e..@e.e...e...ee.eee@..
w...ee@...e@.@e.e..@@e.e@e@e.......w
...e@.e....e.....e.ee.@ee..@..e@e...
...@..e@e...e@..e@e.e@e@@e.ee@e.e@..
w.@ee@e@@@e.@e.e@.....e@@ee@e....e.w
..e....eee.e@@........@eee@e..e.e...
..@e.e...@e@eee@.e......ee@@e@@e@e..
w..e@@e@e@@e...ee@.ee.ee@.ee@eee@e.w
..@eee...ee@@e....e@@e@..e@e@@@.e@..
..e.e@...@..e....e.@e....e@@eee.....
w..ee@...e@eeee.e@.ee@e@..ee@e..e@.w
..e@.e.e.e@e@@@e.@e.@e.e..e@e@...e..
...@e..@e.e@ee@..e..@e....e@........
w.@e@.ee@...@ee...e@e...e@@e.e@e@..w
..e.e@@@e..@e...e@..e@e..e......ee..
.....ee....e.....e..........e@e.e@..
w....@e..ee.@ee.ee.......@e.e@e@ee.w
........e@@ee@@e@@ee@e..@e@..e@.e@..
............@e@.@e.e@e@ee..e@e......
w........e..e.e.e..e@ee@..ee...@e..w
..e@e..e@@e...@e...@e@e@.e@@ee@e....
...@ee..ee...e.@eeee...e.@e@ee...e..
w..ee@ee.@e.e@.e@@@e.e@e.eee@@eee@.w
....@.e@e@ee@@e@.e@e@e....@e@e@@e...
..e.e.@@ee@..e....e..@ee....e..e@...
w.@...ee@..ee@e..e...e@@ee.e.e.@ee.w
..e...e@..e@@e...@e..e@ee@e@e@..e@..