33,36
369
369
1000
...e@e.eee...e@e@ee....e@e@..e@e....
w..eee@@@@e..@eee@@.....e.ee@e.....w
..e@@.eee.ee..e@@ee...e.@..e@@e.....
..e.e@@e.e@@.........e@@e.e.e..e....
w.@e.eee...e@e@e.@e....e@.@e.e@@...w
...e.e@@ee@......e.....@.e@@e.ee....
..e@e..e@.ee@e......e..e..e..e.@....
w.@e.e..e...e@.....e@e@ee@..e@ee...w
..@ee@e.@e...e.ee@e..e@e@e@e@.e.....
..ee@@e@e@..e@e@e....e@@ee@e@.@e.e..
w....e.e...e@e@e@.....ee@ee.e.e@.@.w
....e@.e@e.@e..e....e..e@@e.@..e.e..
...e@e@@.e..@e@@e@e.@e..e@e.e.e@....
w.e@..ee.@e...e.e@ee@e..ee..e@...e.w
.....e@.e@ee....@e@e@@e.@....e.e@@..
..@e...e@..@.e@eee@.e...ee.e@e@eee..
w.ee@e@e...ee@....e..e@.@@.@e...e..w
..e@@e.@e.e.e@e..e.@e.e.ee......@e..
..@ee....e@e@e@..@.e@e..........@e..
w..e@..@ee@@ee...e..e@......eee.e@.w
...@@e.e..ee@@e.@e..e@e....e@@@ee@..
...ee@.....@e@e.e..e@@ee.@ee@e.e.e..
w...ee@e..@e..@.@ee@.ee@.e.e@e.@...w
..e@@.@e@eee..ee@ee...e@ee.e@e.ee...
..@ee.ee@e@@e@@e.e@e..@e.@.e@.e@@...
w..e@...e@e@.e@....@e...ee.@e.e.e..w
..ee@e.....e..e........e@....e@..e..
..@@e@e@.e@e..e@e..e.e.ee@@e.@e.e@..
w.e@e@ee.@e.e.@e@.e@.@e@.ee.....@..w
..e@e..@ee@.@e@.e@...e@e..@....ee...
........@ee@e.e.@eee...@e.e...e@....
w.....e@ee@.e.ee..@@e.@e..ee.ee@e..w
......@e...e@e@@e.e@e.e@.e@@e@..@e..