33,36
372
372
1000
..ee@@e.e.....e@e@e@...e@....e.e@e..
w.@eee@e@....eee.eee@...e...e@e.e..w
..@e@..e@e@e.@@...@ee@......@e..e...
..e@....e@e@@ee@.....e..ee@...@e@e..
w..e.....@eeee@e...ee@.e@.e...e@.@.w
...@e...eee@@@ee..e@e..e@e..e@e..e..
...ee.e.@e..ee@@@ee@@...e@....e..@..
w.e@@e@e@e.e@e@eee.ee..e@@e...@..e.w
..e@e@.....@.@.e@@..@e.e@ee.e.ee@e..
..e.e.e.eeee.ee@@ee.....@e@.@e@e@e..
w.@.@e@e@@@..e..e.@e@e..e...e@e....w
..ee@@ee@ee.e@.e..ee..e@e@e.@e@e....
..e.e@ee@...e.e@@e.@eee..@e.e.e@....
w.@...@ee...@ee@e.@e@@@..e@........w
..e.......ee..e@eee..ee@.@e.........
.....e@e.e@@e..e@@@e@@ee...e.ee.ee..
w.e..e......@e...e.@e..@e.e@e@@.@@.w
..@ee@e.....e.e...e@@ee@e..e..e@ee..
..@e@@ee.e.e@e@e@e.ee@e@e.e@.e..e@..
w.e.ee.@e@.@ee@@@e....e@@ee@e@..@e.w
....@ee@@ee@.@eeeee.@e.e@..ee.e.....
...ee@.e...e@e..@@@.e.e.e@e.@e@.....
w.e@@ee@........eee@ee@.e@..e@.e.e.w
..e@e.@e...ee....@e@@@e..e.....@e@..
..e@.e....e@@.e....ee.....e......e..
w.@ee@..e@..ee@..e..e@e...@..e@e.@.w
.....@e@eee@ee@ee@....@e@.e......e..
..e..e.e@.e@.@ee.e.e..e.e.@ee.......
w.@eee@....e@.e@e@e@......@e@e...e.w
..@e@.e...e.ee@....@ee.e@eee@@..e@..
..e...e@e.@ee@@e...ee@e.@e@.ee..e@..
w..ee@@e......e..e@e@@e.e.e.e....e.w
..e@.e............e..e.e@e@e@...e@..