33,36
360
360
1000
..@e..ee@e.....e@e.@ee@e.e@e..e@e@..
w.e@ee@@@e.....e@e.e.@ee...@...e.e.w
....@e@ee..@e@.@e...e@e@...ee.......
..ee@e.....eeee....ee@e....@@.@e....
w.@e@..e@...@.@e@.e@e@e.e..ee.e....w
....e@e.e..ee.e@e...e@@.@e....@.....
....@@ee@e@@..e......eeee@e.e.e.....
w...ee@@e.eeee@....e@ee@@e.e@...e..w
.......e@.@e@.@e..e.e@.e@@e@...e@...
...@eee@..@e..e@..@..e@ee...ee......
w..e.@e...e@.e...@e.e@@e...e@@.....w
..e@e@....e@e@@e.e@.@ee.e@ee@ee.....
..@e@e....@ee@e.....e@e...e.e@@e....
w...ee.ee@e.ee@.....e@@...@e@...e..w
...e@@.@e.@e@.ee@...@ee..ee....e@...
...e@e..@.e...@ee.....@@e@e@ee@e@...
w.e@e...e.......e@e@e.eee@@@ee@ee..w
..@e@e@e..e.........@..@eeee.....e..
..eee...e@@ee@ee..eee..e@.e...e@e@..
w..@@..e@e..e@e@ee@@......@e..@e@..w
...ee@e@@e.e....@e.e.e..............
..ee@.e@e.e@e.....ee.@.ee@e.e.......
w.@e......e@@@e.e@@@eee@e@e@@......w
..e..e@@e.@eeee@.eee@.e...@ee.e..e..
..@e..ee@..@e..e@..@ee@.e....e@.e@..
w.e@.e@.e@e@.@eeeee@ee..@e...@e@e@.w
..e..e@e.@eeee@@e@..e@...e@e@e.e.e..
..@.e@@e@e.e@..ee....ee@.e@e...@....
w.e...e........@@e...@.e..ee@e@e...w
..@e.......e.e@e@..e.e....@e@ee.....
..@ee@e@e.e@e...e.e@@eee.e@ee@@ee...
w.e.@ee.ee.e@....e@@e@@@ee@ee@ee@..w
......@e@@e@....e@ee..e..e@e.e@@e...