33,36
362
362
1000
....e...e@....e@e.....e.............
w...@e...e......e@e..e@....e.e.....w
..@e..e...e.........e.@e..e@.@......
..e.e.@e.e@.......ee@@e...@e@e...e..
w...@e@.e@@e@e@...@@.e@e@e..@e@e.@.w
....e@e.@ee@..e..eee..ee.e.eee@@.e..
....e@@@ee@..e@ee@@e.e@@e@e@@.ee....
w...@eee@.e@e@......@e@e...@ee@.e..w
..e@.e.ee..e@.ee..e.ee....@e.@e.@e..
..eee@e@@e.@e@@@ee@.e@e...e.........
w.@e@e.e@e@eeee..@ee@.@e...e@ee@e..w
....e@.ee@.@@.e@ee@@@ee@...e@e......
......e@@e.eee@..@eee.@e...e.e......
w.....e@e@........@.e.e@e@e@.@.e...w
....e@@e...e@e....e@@ee@@e@@eee@....
.....e@e.e@e@@.ee@ee.e.e.eee.@@ee@..
w..e.e@@ee@eeee@....e@e@e@@e.e@@.e.w
...@e.e...@e...@e...@e...e@@.eee....
.....e....e...ee..e.e.....eee@@.e@..
w....@e...e@@e@@..@e@..@e...@ee..e.w
....e@....eee.@ee@.e@..e............
....@e....@e..e..ee.e.e@...e.ee@.e..
w...e@ee.e@e...eee@@ee.ee..@.@eee@.w
....@e.@.e@e@.e@@e.e.@e@@e.ee@e@@e..
....@e.e....ee..@e@ee@.ee..e@...e...
w.e@e.....eee@..ee@e.ee@@ee....ee..w
..@e......@@e.e@.@.ee@ee@@@e...@@e..
...eee@..ee...ee@e.@@e.eee..e@ee@...
w..@@.e..@e.e@@.e@.ee..@...e.e@@e@.w
..@ee.e.ee.e@ee.....@..e.@e@@e...e..
..e...@e@@e@...e@e..e.e..e.@ee@e....
w.@....e@e@@ee@@e@....@e.eee@ee@.e.w
..e..e@eee@e..e.e@e...e@e@@ee@e@e@..