33,36
353
353
1000
...@e.e@e@@e@e..e@e@e@e...@ee.@e....
w..e@e.e.ee.....e@e@e@e...e.@.e.e..w
...@e....@ee@...............eeee@...
....@....e@.ee.e...e.@e...@e@@@@e...
w...e.e...e@@@e@e..@ee@...ee.ee.e@.w
.....e@e@.@ee@ee@.e@e..ee.@@e@..@e..
......e@ee@ee@@e@e....e@@eee.e@e....
w.e@ee@.e@e.ee.@ee.e@eee@@@@e@e....w
..@@e...@e@.@@ee@@@ee@@.eeee@e@eee..
..ee.@e.e.e@e...@ee.@.ee..@e...@@@..
w.@..e..........e...e@e@eeee@..eee.w
..ee@e@e.e.........e.e@e@@@@eee@@e..
...e@@e@.@e@.......@e@@e.ee@.@..@e..
w...ee....@ee..e@e....e..@ee@e..e@.w
.....@e..@e@@e.e@.e@e@e@e.....ee....
...@ee...e.e@e..e..e@.@@ee.e@.@@....
w.@e.@...@e....e@e.@e.eee@@ee@ee...w
..e..e.@e.e@e....@.......@e...ee....
...e...e....@e@e.e......@e...e@@....
w.e@.....@e..@e...e...@ee...e@eee@.w
..e@.....e........@e..e..e@e@e@e.e..
..@e.e@e..e@e..e..e@e@ee@ee@@e.@....
w.............e@....e@@ee@@ee.@e...w
..@e.e.....e..@e@....e.e@.e...e.....
..ee.@.e.e@@ee@ee...e@.e@e@...ee.e..
w.e@.ee@..e@e...eee.e....e@..e@@e@.w
..@..@e..e.e@..e@@@e@e....e..@e..e..
..e...e..@e...e@.ee@@e.......@e..@..
w..ee.@@ee..ee@.ee@.e........e...e.w
..e@@eee.@..@e.e@.@e...@e.....ee....
..e@e@...eee@e@e.@e.ee@e...e@e@@....
w..eee@e.@@ee.@eee@e@.e....@e@@e...w
...e@e@e.e@e@.e@@e...e@e@e....e.....