33,36
381
381
1000
..e..e..e@e@e.........ee@e..e@..e...
w.@ee@.@ee...@e..e....@ee@@e.e.e@e.w
...@@@ee.@.e.e...@.@ee@e..ee..e..@..
..eeee.e.e.@e@e.@eee......e@.e@..e..
w.@....@e...e.@ee.@@.......e@..e.@.w
..ee@.e@@...@e@e..ee....@e..e..@ee..
..e.e@@ee...e....e.@e@e.e..e@ee@e...
w.@e.e@e@...@e...@ee...ee...e@..e..w
...e@ee@...e@e@e...e@ee@@.@ee@ee@...
........e.e..e@ee....e@ee.e...@e.e..
w.....e.@e@e....@e...e@@.e@e..e@.@.w
..@ee.@eee@@ee@.e@@e..ee@@...ee@ee..
..e@@e@..eee..e...e@....eee@e@.@e@..
w.....e..@e@..e..ee...e...@e...e.e.w
...ee...ee@...@ee@@e..@....e@e@.e@..
..e@@e.e@ee@e@e.e@@e.ee@e...e.e@e...
w..e@e@e@@@e.....ee@e@@e@.e@@..e.e.w
...ee.e@eee@.....e..e@ee.e.ee.e@.@..
...@@e@e@...e....@eee.e@e@.....@ee..
w..ee.ee@e..@@eeee@@@e@.e.e...ee.@.w
....ee@e@ee.ee.@@@@e@...@.@e..@..e..
...e@@....@e..eeeee.e@e.ee@.eee@ee..
w.@e.e@e..@ee.@ee...e@e@e@ee@@ee@@.w
..e..e@e..e@@e..@e@e..ee....e@ee@e..
........ee.e@@@eee@@ee@@ee....e@@e..
w..@ee@e@@.@eee.e.e..e@@e@......e..w
..@e..e..e......@e....ee@.ee..e.ee..
..e.e....@e@e.e@.....e@..e@@e.@e@@..
w..e@...@e.....e.....e@.......@e.e.w
..e...e@e@@e@ee.e@e@..e..ee..ee..@..
..@ee.....e..e@.e@.e.@e..@@ee@...e..
w..e@.ee@e.e@e.e.eee@e.e@e..@eee.@.w
...e@e@e@e....e@e@@ee@e@.....e@@ee..