33,36
370
370
1000
..eee.....e@ee@..e.e@e@..e@e..@e.e..
w.@@@e...e...eee@@e@..eeee@@@ee..@.w
..ee.@e@e@e..@eee..@e..@@eeeee..ee..
......@..e@.@ee@@e.ee.eee..e@@..@e..
w..e..e@e..ee.e@e@e@@e@@@ee@@e...e.w
..e@e..e@..@e.e@ee.@ee@e....e.e@.@..
..e@@@e...e@e.e@e@.e.e....@e..ee.e..
w.@eee......@e.e.....@e..ee@@e@ee..w
..e@....e..e@e.e..e@.e@.e@..eee@@...
....ee..@..e@e.@e..e@@e.@e..e@@ee...
w.e.@@e.e.e@@e..@@e.e@.e....ee@e...w
..@ee@@e.@e.e...eee.eee@....@@e.....
..e.@e@e.e@.e@....@e@..@e@e.e.......
w.@..e..e....e.ee@@e..@ee@e....e...w
..e.e@..@......@eee...eee@e...e@....
..e@.e@ee........e@e..e@..@e@.e@e...
w.@e.@e.e@..ee@e.@@e....e@e.e.@e.e.w
....e@e.@eee@e@e@ee..e@.e.e@eee..@..
..e@..@e@@@@e@e@@ee...ee@.e.e@@e.e..
w..e..e.eee.e@..e.@ee@@e@.@@e@@ee..w
..e..........e.....e.e..e.ee.ee@@e..
..@.e...ee..e@e@e.e@....@.....e@e@..
w.e@@e.e@@e...@e...e....e..ee.@....w
...e...e@.e@e.e...e@......e@@.e..e..
...ee..ee.e@e.@...@ee@e.....e@e.e@..
w.e@@ee@@e....ee.e..ee@....e.....e.w
..@..@@ee@@e@.e@e@..@e..e@e@e...e@..
..e.ee...@e.e.@e@e..e@@e@eee@..e@...
w.@e@....e..e@..e@@e..e@e@@@e......w
..@e..e..e@..e..@ee..ee@e.ee@.......
..ee.e@...e.ee@e@e@e.@e..e@..e@e@e..
w.@@e..e@e..@e.....@e.e...e..@e.@e.w
..e.....e@e@e....e@e..@e..@e....e@..