33,36
358
358
1000
......ee@e........ee@ee@e@..e@e.....
w...e.@.ee@e.e.e..@ee@.e.e..e@e....w
..ee@@e.@e.e.@.@ee@e@..@ee..@e...e..
..@eee.e@..@eee...e@.@e..@e@..e@.@..
w.@e@@@ee..eee@..ee..e..ee.e.e@e.e.w
..e@eee...e@@.e..@@e@@e@@e@.....e...
....@eee...@e.@..e@.e..e..e.....@e..
w....@@@e.@e..ee@@e..e@eee.e@..e@..w
..e.eee..ee...@.e@e..e@@@@e.e...e...
..@e@e...@@e@.e.@e@..@eeee@e@....e..
w.@e.@e@.ee@e.e@e.......e.e@...e@@.w
..ee@e@e....e@e........e@e@e.ee@ee..
....ee@@e@.....ee.ee@..@.@.@e@@e....
w....@e..e...ee@@e@ee..e.e@e.e@ee..w
...ee..e@e..e@@@e..@ee...@e@.e..@...
...@@e..e@..e@eee..e@@..e@.ee@e.e...
w.@e@e......@eee@e.@ee@e@e.@@e.....w
..ee@.......@e@@..e@e.@e...e....@e..
..@ee...e@..e..e@.e@e.e....@.e..e@..
w.e...e.@e......e@@ee....e.e@@ee...w
..@e@e@...e.e@e.eee@@@e..@e.ee@@.e..
..e@@ee..e@..e@.@e..eee.e@e.e@.ee@..
w.e.e@@.e..e@@e....e.e@e@e......e@.w
..@e.ee.@@e.e.e@e.e@.....@e@...e.e..
.....@eeee..@e.@e.@e.e.e@e.e..e@....
w.....e@.@ee@@ee.ee@e@.e.@ee..@@e..w
....ee..ee.@ee@@.@e@...@...@.eee@...
..@e@@e@@@e....e@e@e...e...e.@..e@..
w.ee@e.ee@...e@.....e......@ee..@e.w
..@e..e..e..e@ee....@e.e@e.e@@@e@...
.....e@..e@e@..@...........e@ee.e...
w..e.e@e.e.e@.ee....e......ee@.....w
..e@.....@e@ee@.e@e.@e....e@e@e.....