33,36
363
363
1000
....e@e@e..e@...e@e.....e@ee@ee.....
w....ee@@..eee@e.......@e@e@.@@e...w
..e@e..eee.@@e@e.......e..e..e.e....
.....e@e.@ee@e@e..e@....e@@e...@....
w......@e@ee@.e@..@e....ee@e...e...w
...e..@e@e..e.@ee...e...@e@ee@.ee...
...@eeee.@e..e@e@e..@e...e...ee@@e..
w..@e@@@e.....ee.@e@e@..e@eeee@e@e.w
...e@.e@e.e@e.e@.e.e.@e...@@@@e.e@..
...ee.e@e.@e....e@e@@e..e@eee@......
w.e@@e@@e.....@ee@e.e.e@....ee@....w
...e@.ee@..@eee...e@e..e@e..@eee@e..
....ee@.e..ee@@e..e@@.e@....ee..@e..
w..ee@ee@..@e@e...@ee......e@@e.ee.w
...@@..e@e@e.e..........@e@ee@e.@@..
...ee...e@.e.@e.........e@ee@@eeee..
w..e@.e....@ee@..ee@ee.e@..e@ee@@..w
..e...@....e.@e.e@..e@e@.e.@e..@e...
..@e..ee..e@e@@.e...e@e@e@....@e....
w..@ee@@e.e@@ee.@..e.....e....e@...w
..e@e..@e@.e.e@.e..@....e@.e@.......
.......e.e.e@ee@e.@ee....e..eee.e@..
w........e@...@@e@e.@e..e@e.e@@e@e.w
......e...e...eee@e.e.ee@ee@@.......
..@ee@@.@e........@e@e@@e@.ee@e.....
w.e..ee.e...e@e..@e@...e.e@ee@..e..w
..e@e@@eee......eee@...@ee@e.e.e@e..
..@@e..e@@e....e@@eee@ee.e@e@e.ee@..
w.eee@e..e@e.e..e@@ee@e@ee@.@e@@...w
...@e@.e@e@@.@e..e@eee@e@.e.e.eee...
...e@e.e@.ee.@e.@e@e@..e.......e@...
w..@e..@e.e.@ee.e..e@e.@e......@@e.w
.......e@e@.e@@e......e@e......ee@..