33,36
359
359
1000
........ee..ee....e@e.e@e.e@ee@e....
w...e...@@e.@@e........e@.....@e...w
..e@@e@ee@..e@................e.....
..@e@@@e@ee..e...e@ee@......e@@e.e..
w...eee.@e@..e@..@e@@e...e@e.e@.e@.w
........e..e@ee.e@e...e@e@@ee.e.e@..
......e@......@e.ee....e..e.@e@..e..
w...@eee..eeee.@e@@e@...e...@e@ee@.w
....e@@@e@@@@@eee@@eee@.@.e.e.e@....
......ee.eeee....ee...eee.@.@.e@e...
w....@e..e@.e@e.......e@..e.e.e@ee.w
.....e@....e@e@.......e@e.....e@e@..
...e@eee..ee@...e....ee.......@e....
w.@e..@@e.@ee..e@e..e@@e.........e.w
..e@.eee@e.e@ee@.@@ee@e..........@..
...ee@e@.@.e.@@e@ee.e.ee@e.......e..
w.e@@ee@@e.@@e.....e@.@@e.....e@...w
..e@e..ee.eee..e@e.e@ee.e.@e..@e....
..@e@e.@.e@@e.ee..e@@e.e@.e....@.e..
w.@e.@@ee@e@..@@..e@ee@e@eee...ee@.w
..e..ee@...e..ee....ee@ee@@@@e..@e..
....e...e@..........@e@e@eeee.......
w...@.e.@e..ee@.e.e@e.e.e@e@e.e@e..w
....e.@e.@e@@ee.@ee@@e@e@@ee@..ee@..
..@e@..e@e.e.@e@@e@ee@...e@...e@.e..
w.e..........e@eee@e....e.......e@.w
..e.e@e....e@..@..@e@@ee@e..ee@ee@..
..@....e..e.e@.e.ee.ee.@@eee@@e.@e..
w.ee...@..@e.e@ee@@e...ee@@@ee@@e..w
..@@e..e@e@ee@@e.@e.@e@e..e@e.ee@...
..e.@....e.e@ee..e.eee@@e@..e@@ee...
w.@.eee.e@.ee@...e.@e@e..e...e@.@e.w
..e.e@@e@.e@@e..e@e@e....e@e..e.....