33,36
353
353
1000
...e@e......e@e...e@...e....e..@ee..
w..@e@.e@e..@e@...@ee.e@e@.e@..ee@.w
..e...ee@e@.e.e..e@@@e..@ee@e..e....
..@@ee@...e..e@...eee@e..e@@e..@....
w.ee@@e..e@..ee@e.e@@....@ee...e...w
......@ee...e@@e....e.....ee@.e.....
......ee@..ee@e.e..e@@e..e@.ee@e....
w..e@.@e@ee@....@.e.@e@..e@.e@@e...w
....e@e....e@e@ee@@ee....@e@.@ee....
....@.@@ee@@@ee..e...e.ee..e.ee@....
w.e@e.ee..eee@@......@e@@.e.e....e.w
..@ee@ee......e@eee@@e..ee@.@...e@..
..e@@.e@..e...@e@@eeee@e@@e@e...e@..
w..ee...e@@e....e.....ee@e..@e@e.e.w
..e@@..eee@e....@ee...ee@e..e@@e@e..
....e.e@@ee@.ee@..@e..@e.@e...e.e@..
w...@ee@...e@@.e@ee@..e@.ee@....@e.w
...e@@eee@e.ee..e@...e@.e@.eee..e...
....e@@@@e.....e.@e.........@@.e@e..
w....eee@e.e...@.e...e@.e.e.ee@e@@.w
...e@e@..e.@e@ee....e@ee@e@.....ee..
...e@@@ee@.e@e..ee..@..@e.ee........
w..eeee.ee.@.@ee@@e.e.e@ee@@...e...w
...@@...@@@ee@@.@e....e@ee@e.e@@....
...ee...eee@.ee@ee@e@e@@ee@e..ee....
w.e..e..@@ee.e@e.....@ee.@e@@e.@@e.w
..@..@e@ee@@...@e...@e.....ee..ee...
..e..e...e@e......e@e@.....@ee@e....
w.e@.@e@e...ee....e@...............w
..@e.e@.e...@@e...ee...e....ee@e....
...e.@@e@...ee@..e@e.ee@e@e.@e.ee...
w..@eeee@..e@@...@e..@e..@e...e@@e.w
...e@e@.e....e@e.e@..e@..e@.....e@..