33,36
355
355
1000
..e@e....e.ee@e@@e......e@e@@e..e@..
w.e....ee@.@e..eee@e@e...e.eee...e.w
..@e...@e......@ee@e@e@e@e@..@e.ee..
..e........@e@e@e.e@.e@.e.e....e@@..
w.@e......@e@e@.....@ee..e@@e.e@@e.w
..@e......e.......e@e@....ee....e...
..e........e..@e.e@ee@e...@....e@...
w...ee....e@..ee@@eee@.e.ee...e@e@.w
....@@e@@eee....ee.@.e.@e@@...@e.e..
....e.@ee@@@e....@.e...e.@e..e...e..
w...@e@e@ee......e..e@e..e@e.@e.e@.w
....ee@e.@e...ee.@e.ee@ee@.@.e..@...
...@ee@.e@e..e@@e@ee@@@e@..e.@e@e...
w..e@.e@e@ee@@e.e@ee@ee....e@e@e.e.w
..e@...e.e@.ee@@e@@ee.........e@e@..
..@.e..e.....e@e.e..@e.......e@ee@..
w.ee@e@@e...e@e.@e.........e.ee@ee.w
......e.@e..@e@.e...e@e..e.@e@@.....
..eee@@ee.ee@e@@e.e@e...e@.ee.e.....
w.@@@ee.@e@@eeee......e@e...@e@....w
..eee@@.e@...@@e..ee..e@e@e@@e......
...e@ee..e...e@e@e@@e..@e.@ee....e..
w.e@e@..e@e@..e@e@@e@..e...@...e@@.w
....e..e@@eee@e@.eee@..@e..ee@e.ee..
...e@e...e....@e.@e@e..e...ee@.e@e..
w...e@..e@..e@.@..@e.@e@...@ee..e@.w
....e@e.e@@e.eee.e.e@e..e...........
...e@@e.@ee..e@.e@...e.e@ee..e@e.e..
w..@@e@e.@e....e..e.e@..e@@...@ee@.w
...eeee@.......@ee@e@...@@eee.e.e@..
..e@e@@e.e.......@@e@e..eee@@e...e..
w.@e@.e@.@e......eee@e.e@e@e@ee@...w
..e.....e@e........@e....@e...@e....