33,36
360
360
1000
..e@e.e@e....e..e@.e@.e@ee@e@e......
w.....e@ee...@e@ee.@e@..@.ee@@ee@..w
...ee@ee@@e..@e.@e@e.e.@e.@ee@.@e...
..e@@ee@..@e.e.@ee@e...e..e@ee......
w..@ee@..e@@e..e....e@ee...e@...@e.w
..@e.e@..@e@ee.@......@@e.@ee.e@e...
..e@e.e....e@@ee.e@e..e@@.ee@.......
w.e@.....e.@e..@ee@e..@ee....e@e...w
...e....e@@e..e@@e@e..ee.e..ee......
.......ee@e....ee@.@e@e@e@e@@@e@e...
w.e@e@e@e...ee.@eee@ee.....ee@@e...w
.....e@....e@@ee@@e..e@e..e..e......
....e@@e...e@ee@e...ee@ee.@e..e.@e..
w..ee@ee@e.....e@...@@e.@e...e@.e@.w
...@e.e@@e..e..@.e..ee@e@.e@.@e.....
......@eee.e@..e.@e.....e..e...e@e..
w....e@e.@e.@eee@...e.......e....@.w
.....e@e...ee.@ee...@e..e@e.@....e..
...@e@e@...@.....e@..@e...e.e.@ee@..
w..ee@e....ee@e..ee....@ee@...e.@e.w
.....e@....@e.@..@....ee..@e.eee.e..
...e.@eee@ee@@e.ee@...@e@.e@e@@@e@..
w.e@.@e@@e.@@eee@.e.....e...e@ee.e.w
.....e@....ee@@@ee..e.....e@e@..e@..
.....e@e....@ee..@.e@.....e@eee.@e..
w.e@e@.@ee..e@e..ee@.e@...e@ee@.e..w
..e@e.e.e@e.e@@e@.@e.@e..e@e..e.....
..e@ee@ee@@..e@eee.e.......@e.@.....
w.@@eee@.ee..e.@.@e@......ee..e.e..w
..ee.@e@....e@@e@e.@e.....@@eeee@e..
.......e@e....e...@ee@.e..e@e@@@ee..
w...@e@@e.......e.e@ee@@e.@e.@e@e@.w
..e@e.ee@.......@e.e@.e@e.e@.ee@ee..