33,36
346
346
1000
.....@e@@e.....e@@ee@e@e.eee@e.eee..
w.e..e.ee.......ee@e..ee@@@.e@.@@@.w
..@..@e..........@.@.e@.eeee...eee..
..e@e@@e@e....e@.e.e@e@e..e@...@@...
w....e.@@eeee..e...e@.....e.e.@ee..w
.....@.ee.@@@e@@.e.ee...e@@e@ee.....
...e@e....eee.eee@.@eee.@ee.e@......
w..@e@..e....e@..@e@e@@e....@eee.e.w
.....@e@@e@.e@ee.ee@e.....ee@.@@e@..
.....e.e..e@e.@@e.e.eee@..@@e.e@@e..
w..e@e@...ee@ee..e@.@@@e..e...@e...w
....e@e.e@@ee@....@eee...e@.....e@..
..e@@e...e@@@e....e@e@e...ee....@e..
w..e@e....ee.......@ee@...@@.e@e...w
..e.e@e@e..@.e.@e..e@@e...eeee@e....
..@e.ee..e@e.@.e...e....ee@@@.e@....
w....@@...@e@e.e@e.@e..e@@.ee......w
.....ee.e.e......@e@e@@e.e..eee.....
..e@....@e.e...e@e@@eee.@e.e@@@e.e..
w..eee@e...@...e@..e.@e.e.ee@e@ee@.w
...e@@e..e@ee..ee.....e@e.@e@e...e..
...e@...e...@e@@e.e...e@@.e@.@e..@..
w..@e.e@@e.e@ee.@e@.e@@ee@.......e.w
..@e...e@e.e@ee@eee.@e...ee@e....@..
..e.e.e....e@ee@e@@e.....e@e@e...e..
w...@.@e....@ee@ee@@..e@e@@ee@.e...w
....e...@e.eeee@@eee......e@..e@@e..
....@e..ee@@e@.e@@e@.e@.....e@e@e@..
w....e@@e.ee....eee...e..e@e.e.....w
.....@ee.e@@e@...e@...e........e.e..
..e....e....@e..e@@e@e@.e@.....@e@..
w.@e@.e@@e...@ee..e.e@..@e.....@e..w
...@e...e@..e@e@........e@.....e@...