33,36
361
361
1000
........e@...@e........@e...........
w.@ee..e.e.e.e@e@e.....e.ee...@e...w
..e@@e.@.e@@e.e@e@...e..e@@e..e.e@..
....@e.e.ee@e.e......@e.e@e..e..@e..
w..ee...e@@..e@.e..ee@e..e@..@e@.e.w
..e@@e@e.ee@e.ee@ee@e@e@.....e.ee@..
..e@e@...@@..e@@e...@e.e.....@e@.e..
w...e@.e.eee.......@e....e@e.@e.e@.w
.....ee@.@e@.......e...e@.@e.ee.@e..
..ee.e.@e.....e......e@eeee..@@e@...
w.@@.@ee......@.e....e@.e@..@e..e..w
..ee..@e...e@eee@@e...e.e@e@e..e.e..
..@.e.......ee.@@e..ee@.@e@e...@e@..
w.e.@e.ee@e.@@.ee...@e@e.e.@e.e.e@.w
....@ee@@@e@ee@e@e@e.e@e.@@e..@eee..
....e..@eee@e.e@.e@e..@eeee..e.e@@..
w.....@e@@@e..@e@..e@ee.@eee.@.e@e.w
..e.e@e.@e@...e.e..@@e...e@@.e.@e...
..@.e@e.eee..e@..e@ee....e@e.@e.....
w.e.@e...@e..@.e@.e@@e...@e@@e@e.e.w
.....@eee..e.e..e@....e@e@e.e.e@e@..
..ee.e@@@..@e@...e.@e.ee...eee......
w.@@ee@eeeeee@e.e@.e..@@e@e@@@.ee@.w
..e..@e@e@@@@e.e@ee@e.e...e@ee.@ee..
..ee..e@e.ee..e@@e@...e@e.e@e....e..
w.@@e...........ee@ee.@e@.e@@e@e@@.w
..e@ee@ee.e@...e.e@@@e.....e.@e.ee..
.....e@@@e.e...@e.ee.....e..e..ee...
w.....eee@..e@e@e......e@@e.@e@@@e.w
........@...@.e.e..e...ee.@e@eee@e..
...@e...e.e.e.@e@..@e.e@..e..e@.e@..
w..e.....e@.@.e.@e@@e.ee@e.e.@e....w
........e@..e@e@e.ee..@e..e@..@e....