33,36
367
367
1000
...e@e@e..e@....eee@@ee@e@....e@e@..
w.@e.e@....e...e@@@ee.e..e.....eee.w
..e@..e...e.....@e...e@.....ee.e@...
.....ee@ee@...e@ee@e.e.....e@@e.....
w....@e....e@e.@e...e@@e.ee.e@.....w
...@e@..e.e.ee.e..e@..e.e@@e.e@.....
...e.e..@.@e@@eee.eee@e.e@@e..e.....
w...e...e@e...@@@e@..e@..ee@@e.e@..w
....@....e...@eee@@e@e@e@..@e.e@e...
...ee....@.eee..@ee@..@ee@.e.e......
w.e@ee@e.ee@@ee...e@eee..e..e@..e@.w
..@@e@@e..@e.@@..@e@e@@..@e@e....e..
..ee..e..e@..ee.eee@e.eee......e@...
w.@@.eee..e.e.@e@.....e@@e@e@e.@e..w
..ee.@@@e@ee@.....e.ee....e@e@.@e...
.....ee.e@e.....e@@e@@e........e....
w....@@e@@ee.....e..e@e.....@ee....w
...e@e@e@ee@@e..e@.e.e@@e...ee@e....
......e@@ee@e...e..@ee@e@.eee@e.....
w.....@.e@....ee@e@ee@....@@ee@e...w
.....eee@eeee.@@@e.@@e..e.e.e@@ee...
.....@e@.e@@@.eee..e.@ee@e@...e@@e..
w..@e...e.@ee.@e@e..e@e@.@e..e@.@e.w
...e....@.e@..@e@@e.@e@.@e@e@e..e...
.....@e.e..e@ee@e@..e.e.e.....e@....
w....ee.e.eee@...e...e@ee.e@...eee.w
....e.@e@e@@@ee..@e.e@.e@e.e..ee@@..
....@e@ee@.ee@@e.e@....@.@e..e@..e..
w.e.e..e@e.e@e@e.@.....e....e.@e.@.w
..@..e..e@e@.e@e.ee@@e......@ee..e..
..e..@e@e.e@ee@.e..ee.e....e@ee@....
w....e....@eeee.@e@e@e@.eee@@e.ee..w
...e@ee@e..e@@e.ee@e...e@@e.e.e@@e..