33,36
356
356
1000
..ee..ee@e.eee@.........e@@e..e..e..
w.@@.e@e@ee@@@e..e@e.e...ee@.e@.e@.w
..ee.e@@e.e@e@e......@e...@..ee.@e..
..e@e.e@e.e@e@e...e..e@.e@e@e@@.e...
w.e@@e......e@e@ee@.....@ee..@ee.e.w
...ee@..e@e..e...ee.....e@@e.e.@e@..
..e.@e..e@eee..e.@@e.e@e.e@...e@e...
w.@...e..e@@@.e@ee@..@....e@..e@...w
..e..e@ee@@eee@@e.e..ee.e.@e...e....
..@e..e@e@e@e.ee.....e@e@.e....@....
w.e@.e@...e.@e@...@e.e...e@....e...w
.....ee@e@@.e....ee..@..@e@e...@e...
....e@@e.eee.e@e.@e..e..e@......e@..
w..e.e...@e@.@e......e..e@..e@e..e.w
..e@e@@e.e@..e@.e..@e@..@e..@e......
..e@@@e@.......e@..e....e@..e@@e....
w..eee...e..ee@e....e.@ee@@eeee@...w
..e@.@@ee@e@@@e.....@ee..ee.@@e.....
..@e.ee...@ee..e@e....e@e@@eee@ee@..
w.@ee@......@e..ee@eeee.@@e.@@e..e.w
..e@@e...e...e@e@.e@@@@eee..ee@.....
....e@...@e....e@e@.ee...e@e...e@...
w....e...@e.e.e.e........@e...eee..w
...e.@.e.e..@e@.@........e@...@@ee..
..e@.ee@..e@ee.@ee...e@e.e@e..e@e@..
w......ee@@e@@eee@.@e@..e@e...@e.e.w
..@ee..@eeee@@e@...e....@.@...e@e@..
..e.@@e....@ee.@e.e@...ee@e..e@ee@..
w...eee@@e..e@.e@.@e...@....e@e@@e.w
..e@e..ee.e@@@ee@e@....e....@.e@e...
..@e@e@e..@eee.e@ee......ee.ee@..e..
w.@e...e@e..@..e@ee@e@..e@@e@..@e@.w
..e......e@ee.e@e....e.e@ee....e....