33,36
351
351
1000
......@ee@e@e@e.e@@ee@e.ee@@ee@e.e..
w.....e.@e.e....@ee.....@@ee.@e..@.w
........e@.e.e..ee......ee@...@..e..
.......e@@e@e@e.@@@e..........e.ee..
w.....e@.e.e@.@eeeee@e.e@e.e@@ee@@.w
..e@....e.e@e@e.@.e@@e...e@eee..ee..
...e..e@@ee@.e@.eee.e.......e...@e..
w...e..e@.@e@.e@e@@........e@e..e@.w
...e@e..ee@ee.e@..e.......@e.@ee@e..
...@e@.e.@e@.e.e..........e..e@@e...
w..ee@.@.....@e..e@@e@...ee..e@@e..w
...@@e.e....e@e@e@ee@e..e@@e..ee....
...e@@.e@..e@e.e@.e@@e.....@........
w...eee.eee@e......@e.e@ee@e.......w
....e@@e@@e@@e.....e..e@e@..e....e..
....e....e.e.@e@eee@e.e@e@..@..e@@..
w...@eee.....e@..@@e@.e@ee..e..@ee.w
...@e@@@.e......ee..e.@e.@ee..e@@e..
...ee@eee@...e..@@e@@...e@e@..@eee..
w.e@@e@....e.@..e.@ee..ee@@....e@@.w
..ee..ee...@@e...e@ee@e@.ee......e..
..@@e.@@ee@ee@.e.e@e.e@......e@.e@..
w.ee@.ee@@e.eee@....e@eee@e...e.e@.w
...@e@......@@eee@...e@@e@@e.....e..
.....e...ee.ee@@ee@e....@e.e.e@.....
w..ee@...@@e.e@e..@ee@e@e..@e.e..e.w
...@ee@e.e....e@@ee........e@..e.@..
..e.@@.e......@ee.......e@e....@@e..
w.@eeee@@e...e@@ee......e@e....eee.w
....@@e@e....@e.e@e@...e@e.....@e@..
....ee@e.@e..@e@e@.eee.e@@e@eee@e...
w..e@@.e.e..eee..e@e@@e.ee@e@@e@@..w
...e@ee@...e@.@e.@e.........e@eee...