33,36
356
356
1000
.......e@@e........e@e@e@@e@.....e..
w.ee@e.eee@e@@e......e@.ee.e....e@.w
..@ee@.@ee@eee.e@...e@e.@e.....e....
..e...e@....@@e.ee@.@...e@e@ee.@....
w.@e.eeee@e.e..@e.e.e@ee@e...@ee.e.w
..e@.@@e.......e.....e@.e@......e@..
.....e.............e@e@.@e....e@....
w.....e@.e..e@e..e@@eeee@e.e@e.e...w
....e@.e.@e..e.e..ee@@e@@e@@e@......
..e.@e.e@e@.e@.@.e@@.e@.e.e.e@e.e...
w.@e.e....ee@@ee@e@e......@.e@e.@e.w
..eee@.e..@e.e.e@ee......@ee.@e.....
..@@ee.@.e@e..e@.@@e@ee..e@@.e@.e@..
w.e.e@.e@e@eee@..e@e.@@....e...e.e.w
..e@@@eee..e@e@e.e...ee...e..e@@e...
...eee.@e..e@@...@ee@e.@e@@...e.....
w.......e@eeee..@e...@.e.ee........w
.........e@@@.e@e@ee@e........e.e@..
.........@eee..eee@e@ee@e....e@..e..
w..e@ee@..e.e@e@@@ee@@.......@e@.e.w
.....@@e..@e@@e@e..eee.........e.@..
.....e..e@e.ee..e.e@@e@e@e..e@e..e..
w..e@....e..@@.e@.@ee@e@e@..e@ee@e.w
....e....@e@ee..e.e@..e.e@e.@e.@e...
.......e@e.....e@.e@e.@.e@e..@e.....
w..e@e@e@.e@.eee..@e@@e@e....e...e.w
...@e@@ee.@e.@@@e@e..ee@ee@@e@.e.@..
..e@e.ee@..e@eee@.....@@e.ee...@.e..
w.e@e.e@....e@@ee@ee.@ee.e@@...e...w
..e@e.e@ee.e@.e@e@e@.ee@e..e........
......ee@@e..e@e.eee....@e.e@e@.@e..
w....e@..e@.e@@e.@@@e....@ee@ee.ee.w
......e@e@..e@e..ee@e...e@e.....e@..