33,36
354
354
1000
.....e@e@..e@e.....e@e..e.....e@e...
w....@e.e.e@.......@e...@e..@e@e@..w
...e....@e.e@.....@e.e.e@e@ee@......
...@e...e@.@e.e...e.e@.e@@..e.e..e..
w.....eeee@..e@e.ee.e...ee..@e@.e@.w
......@@@.e..ee@e@@e@....@.e@e...e..
......eee....@@..@e.e..@ee..@e...@..
w.....@e@.@e@ee.ee@e@..e@.e@ee@..e.w
...e@@e...e....e@@ee@e..e.....e.....
..@eee@....e...@@e.e@@@e@..@e@..e...
w.e......e@@e.eeee@.eeee@..e.e..@..w
..@e...ee.e@ee@.e@eeee.ee.......e...
...e...@@ee@e@..@ee@@@e@@ee@e@e.....
w..@e.ee.@.@e..e@@@@e..ee@ee@@ee...w
..e@e.@.ee.e....eeee.e@@@e@e@ee@.e..
..e@@eee@@ee..e@.e.@e.eeee.@ee@ee@..
w.@ee..e@.e@...e@@e@e..@e@...e@@e..w
...@@e..ee@e..@ee.e@e.e@e.....e.....
...e..ee@ee@.ee...e@e...............
w.e@@e@.e@@ee@e...e@e@e@......e@...w
....e.@e@.e@@@e...e..e@e.e.....ee...
..e..@e.e@e.ee@..e@e.@@e@@.@e...@...
w.@e.e....@e.e@e.@e@.ee.ee.e@e..e..w
..@e..e@.....ee@e@....e..e@ee@..ee..
..ee@e.ee@...@.e.ee..e@.....e@ee@@..
w.e..@e@@e...e.@..@e.....@e.e@ee@e.w
..@e.e@...e@e@.e.e@@e....e..@.e.@e..
....ee.e@e@@e@e...e.@@e.e...ee@.e...
w..e@@.....e@@e...@@ee..@..@e...@e.w
...e.ee@e@...e..e.ee@...e..e@e@e@...
...@e...@ee@e..e@..@e@e@......e@e...
w.e@@e..e@e.e@@e..e@ee@e.e@ee......w
...e@e@e@e...ee......@e.....@e@e....