33,36
360
360
1000
......e..e@@e..e@e@e.@e.e@e.....@e..
w..e.e@.e.ee@..@e.e..ee@@.e.....e..w
...@e@e.@...e@...e....@ee.@ee@e.@...
...e@@e.e@e.@e..e@..e..@ee@.@e@.e...
w.e@ee@e.e@.e@ee..e.@e@e..e...@ee@.w
..@...e@..e.@e@@e@@.e...ee@e@ee..e..
..ee..e@.e@eee@e.ee..e@e@..@@e......
w..@e..e...@@eee..@.@e.....ee...e@.w
...e@.....ee..@@e@e.e..........e.e..
...@e...ee@...e...e@@e..e@ee.e@@.e..
w..@e..e@e@.e......e.....e@@.eeee@.w
...e...e@ee.@ee@...e..@e...ee@e@....
...@.e....@....e..e@..e...e@..e.....
w.ee.@ee..e..ee...@e.....@e@e.@e@..w
..@e..e@@ee@e@@e.e@e.....e..e.e@e...
..@e....e@.e@@e@e@@ee.e@....@e@e@...
w.e...e.@e...e....ee@..e...e..e.@e.w
......@e@e........@e@e...ee@.e@ee...
......e..@e.@e.@e..@@e..e@e@e@e@....
w..e....e...e.@e.e@ee...e@@..@e.e@.w
..e@e@e.@e....e@...@.e...eee.ee..e..
..@.e@@e@....e@.e@eee@.@e.e@.e@.....
w.e.ee@ee@........ee.e.e@.......e@.w
..@e@@eeee..e@..e@@@e@..ee.ee.@e.e..
...e.e@@@e.e.e...eeee@e@@@e@@eee@e..
w.e@.e.e@@e@.e...@ee@e.eee..@e.e@e.w
..@@e@.@ee..e@..e@e@e@.e@@..e@.@e@..
..eee@ee@e..e@e@e.....@e@ee@e@e.....
w.@.e@@@e@e..e.....e..e..@.e@e.....w
..e..eeee@@....e@e.@.....e..e@@e....
......e.@ee...ee@e@e@...ee@e@.e.....
w.ee@e@e@@eee@@ee@@ee..e@@@e.e@@ee.w
..@e@e..e.e@.e....e......ee@.e@ee@..