33,36
356
356
1000
..e@@e.e@ee@e..@e....e@e@e@e@e@@e...
w..ee...e@e.ee.e@.....e.@e@ee.ee@..w
...e...e@.@e@@.e@e..e@e.e...ee@.....
..e@e@e.e@e..e.@e@..@eee@@ee@.......
w.@ee@e....e...e.....e@e@ee@..eee..w
..@e....e..@e.e...ee@.@ee@e@ee@@@...
..e@@e.e@.e@e.@e..@@e@e.e.ee@@@ee...
w...e.@e@e.e@.e@.ee@e@@e@e@@eee@...w
...e.ee@e.......e@...e...e@e.@@.....
..e@.@@e@..e@e.@e@e...e..@..eeeee...
w.@.ee@e..e@.@.e.e@...@e@e..@.e@@..w
..e.@..e@....e........e@.@e@e..eee..
..e@e..@e@e.........e@e..e@.@e.@e@..
w.@eee...e@.......e.e@e..@@e..e@.e.w
..@e@@...e@e.....e@e@...eee....ee@..
..ee@e@e.ee@............@e......e@..
w.....e..@e.....e@e@@e@...eee....e.w
......@e.e@...ee@.eee.e..e@@@.......
..e..e@@e...ee@e.e@@@.e....ee.......
w.@.eee@e..e@@...e.ee.@ee@e@...e@..w
..ee@@e..e.e@e..e@@e.....ee..e..e...
....e@@e.@.....e@@e......e@.e@..@...
w....e@..e....ee.e@...@e.@eee@e@ee.w
..e...e.e@.@e.@@e..@eee..e.@e.@e.@..
..@e...e@e.e..e@...ee@..e@e...e@.e..
w..@e....@....@e........@e...e@....w
..e@ee@..e.....ee@..ee....e@@eee....
...e@@ee@e....e@.e.e@@e@e..ee@@@e...
w..e@e@..@....@e@....e....ee@.e.@e.w
..@eee..ee..e@eee..ee@..e@@e...e@e..
..ee@@ee@@e.@ee@@ee@@e..ee...e@@ee..
w.e@...e@..@e..e..eee@e@@.e@.eee@@.w
..e@e...ee@e...@ee@@e..ee..ee@@e.e..