33,36
365
365
1000
..@e@ee@e.ee@e.e@eee.....@e@.@e.....
w.e.....e@@e.e@@e@@@e..@ee.e.e.@e..w
.....e@e.e....e..@e@...eeeee@e.e....
......e@.@.......e.e@..e@@@@e.e@e...
w...@e@..e@.ee......e@..eee...e@@e.w
....e..@e.ee@@@ee@...eee@@e...@ee@..
...e@e.e@ee@.ee..e.e.e@@ee.....e@...
w..@e@.ee@e.......e@e@.e@@e.e..ee@.w
...e..e@@e........eeee..e@..@ee@.e..
..e@..@ee...eee.e@@@@@@eeee@@ee@e...
w.......@e@e@@@e.eeeeee.@e@ee@@e@e.w
.....e....e.@e..e@@......@e.@.ee@@..
.....@.e@e..e.e.e@e@e.....@ee@@.ee..
w....e.e@@e.@.@@e............ee....w
.......@e@e@e.ee@.e@e.....@e....ee..
....e@e..e..e@.@ee........e@..ee@@..
w..e@e@..@e@ee.e@@e..e..e.eee@@e@e.w
..@ee...@ee@..e@e@...@ee@e@@@ee.....
..e.@e..e@.e@ee@ee..e@e..e@e@@@.....
w.@e..........e@e@.e@..e@ee.eeee@e.w
.......e@e....e@e@....e@e@@e...e@e..
..e..@ee@....e@e.e......e@e.@eeee...
w.@@ee..e.e.e@e.@e.......@e.e.@@@e.w
..eee.ee..@e.e@ee........e..e@ee@e..
...e@e@@ee@@e@e@@e.ee..e..e.e@@.....
w.e@ee@@e@e....e@ee@@@e@@e@.eeee@e.w
..@.@eee.@e@e....e..eee.e...@@..@e..
..ee@.@.@e.@ee@.e@e.e@@ee...ee@ee...
w...e.e.e@.e..e..e@...e@@.e..@e.e..w
...e..e@e@eee@e.......@.ee@..e@e@e..
..e@e@e....@..........ee.......ee@..
w.@e@e@....e.........e@@.ee.e@e@ee.w
................e@e..e@ee@@e.e@ee@..