33,36
363
363
1000
....e@e@@e.e@@e@@e.e@e@...@e@@e.....
w...@e.ee..@ee.ee..e@ee...eeee.....w
..e.....@.e.e@.e..e@@e.....@e@......
..@e....ee@...e@....e....e.@e.......
w.e@......e@e.@ee@e...@e@@ee...e@..w
.......e.@e@e..e@@e...e.e...eeeee...
..e@@ee@eee@e.ee@e..e.@e@.e@@@@@e...
w..eeee@@@e@.e@@e@.e@e@e...eeee@...w
.....@.ee@.e..e...e@@e@e....e@@e....
..e@.e..@e...e@.@ee@e....ee.@@e..e..
w.ee@ee..@ee..eeee@@e...e@@.ee.@e@.w
..@e@e@e@.e@e@@@e@@e.e@e@@e..@.e@...
..eeee@.e.e@@ee..ee..@e@.e@e.e.e....
w.@@@.e.e@ee.e@..@e..e..e@e@ee.@ee.w
..eee@@e.e@.e@e..@e........e@@@ee@..
.....e.....e@e@.@e......ee.e@ee.@e..
w...e@..........e...e@..@@.e@e..e..w
....ee@e.e@e..e......e..ee.e@@......
..@e@@e.e.eee.@e...@ee@e..e.ee...e..
w.eee@e.@.@@@ee@.e@e...e..@e.@e.e@.w
...@ee@.eeee..e@....@ee@.e@@e@@e@e..
..e@@e@e.@e....e@...e@e@e.ee.e@@ee..
w..ee..e@e.@e...e....@e.e@....e@e@.w
..e@..e@...ee@ee.....e...ee@e...e@..
..@e.....e@.ee@@e....e...ee@@e...e..
w.e.e.....e.@@.......@..e@.ee..ee..w
..@e@.....@.ee...ee.ee...@e.@ee@@e..
..@e......ee..e@e@@e@@e.ee.e@@@e@e..
w.e....e.ee@...e..e.ee@e@..@eee.e@.w
......e@.@e...e@@e..@eee@e@.@ee.e@..
.......e@@e...@eee.e.e@@e.ee@e@..e..
w..e...@eee@e@e@.@e@@e@e...........w
..e@.......e@....e@.e..@e...........