33,36
370
370
1000
...e.e@...e@.e@e@e@e.e@e.e@@e@e.....
w..@e.e.e@ee.e@e..@e@.....ee.......w
..e@e.@e.@e..@e.e.e@e....e@@e.e@....
..e@e...ee.e..@e@@e..e@@e@....@e....
w.@ee@e@@ee@e.@e@e.@e@ee@.e..e@@.e.w
..@e.e.e@@@e..e...ee..e@.e@e@@eee@..
..ee.e@.ee..e@...e@...@ee@@ee.ee@...
w.e@e.e@e....e.e@e.e.e@ee.e.e@@@e..w
...e@...@e..@ee@e@e@.e.e@....ee.@...
...@ee@e@.eee.....@@e@ee@..e@@e.e...
w..ee@e.e.@@e@e.eeeee@@ee@e.e.e..e.w
..e@..@..eee@...@@e..e..@e@...@e.@..
......e..@@@ee@ee.....e@e.....e..e..
w.e@e....ee@e.e@.....@e..ee@..@e...w
..e@e.....e..........ee@.@ee........
..e..ee@e@@ee@......e@.ee@e@....e...
w.@ee@ee.e@..e..e...e@e@e@@e....@e.w
....@e@.e@e.e..e@@e..e@e.e@e....e@..
...e@e..@...@e.e@e.e@.e@@e.ee@e..e..
w..e@e.ee..e@e.e@e..e...e.e@@e@.e@.w
...e@e.@ee...e@.e@e@.@e.@e..e.......
..e@ee.e@@e.e.eee@ee.e....e@@e......
w.@.@@ee@e@.@e.@e@...@eee@.e....@e.w
..e.e.ee@e.....e.e.e@@e@eee..e..e...
...e.e@@e.....@e@e..eee@@@@e.@..@e..
w..@e...e@e@e.e@ee..e.@eeee@.ee@e@.w
........@e.....e@@@e@.@e@.@e..e.....
........e@e..e@e.eee@ee..e@e..@.....
w........e@..@e.e@@e@e........ee...w
..e....@e..e@ee..e@e@..@ee@e.e@@e...
..@e...e......@e.@e.e..e.@@e........
w..@ee@ee..e.e@ee......eeeeee..e...w
......e@@ee@.e@e@.....e@@ee@@ee@....