33,36
365
365
1000
.....ee@e...e@e.@e...e@@e@e@eee.....
w.e@e@..e.@ee@e@e@...eeee@..e@@e...w
..e@e..e@ee.e@e..e...@e@.e@ee@e.....
...e@e..e@e@e@ee@@ee@e@..e.@ee@.....
w..@.@..@e...@e.ee@e@.@e.@.e@e.e@e.w
..@e.e.e....ee...e..eee@.e...@.@@e..
..e....@e@e.@ee@e@...@e@e..e@eeeee..
w.e.e@e@e@ee@ee.ee..e@@e...@e.@ee@.w
..@ee@@e@e..e@@e@@e..e..@e@e....e...
.....e...@e.@e..e@@....@eeee@e..@e..
w.e@e..e.e@...e..ee....ee@@e...ee@.w
...e...@e..e.e@..............e.@.e..
..e@.ee@...@e.@e.e@ee........@eee@..
w.e@e@@ee.e...e@.e@.@e..e@e@e@e.e..w
..@ee@ee@.@.......e.e@@e@..@eeee@e..
....e@e...ee.e@e..e..ee..e@e.@@e.@..
w.....@e..@@e..@e.@e.@.......e@e@e.w
......e.e@e..e@e...eee..e...ee@.....
....e.@ee@e@e@e@..e@@@e.@e.e@@e@.e..
w..e@...@@e@e.e@@e@.e@e@......eee@.w
.....e..eee@ee.ee....e.e@ee@..@@e...
.....@e.e@e@e@.......e@.e..e@eee@...
w..ee.e@e@ee@@e..e@e@.e@@..@.@ee@e.w
..e@@e@e@....ee.e@e.eeeee.ee.....@..
..e@@e.e@e.e.e@e@..ee@@..e@....e.e..
w.@ee..e@e@@e.@e@.e@e@e.e@.....@...w
...@.@e@e.e@e.eeee@@e..........e....
..eeeeee..e@@e.@@e@e.@e..e......@e..
w.@.@e@@e..e...e@ee@@e..e@......e..w
..e...........ee@.e@ee@....e@e@e....
....e.e....@e.@ee.....e.............
w..e@e@.ee.e@e....e.e......@e...e@.w
.....@ee@@e..@e..e@e@......e.....e..