33,36
348
348
1000
........@ee@e.eee@@e..e.............
w...e..ee..@ee@@.ee@.e@e.....e.....w
....@ee@@e@e...e.e@@e@e@...e@@e..e..
..e@e@...e@@e...e@.ee@e@e@..e@..e@..
w....e.@e.e.ee.e@e@.@@e..e..@e..e@.w
.......ee..e@@e...e.ee@..........e..
......e.@e.@e@@.e@ee@@..@ee@e.......
w.....@eee@@eee@@.@@ee..ee@e.......w
..e.e.e@@eeee@@ee.ee..e@e@@e........
..@e@.e@.......e.e@@e.ee@@e.e@e@@e..
w.e@...ee.e@@e.@.e@eee@..ee@.e.ee..w
..e@@ee.@e.ee@.eee..@@e.e@@e.@..@...
...ee.@e....e..e@@e@e@e..ee.@ee@e...
w..@.e..@e@e@.e@ee.@e@e..@@ee......w
...ee@.@e....e.e@@eee..eee@@e.......
..e@e@ee.e...@ee@@e.@e@@@@ee..e@e...
w...e@@@e@.e.e..ee..e@eee@@@e......w
....eeee@.e@.@e..e......eee.@e......
..e@@e@@e@@e@e.@e@@e@ee.@......e....
w..e@ee@ee..@e@e..e.e.@ee......@...w
......@e@...e.e...@e@.e@@ee....e....
......e.....ee@...ee@ee..e@.e@@e....
w..........e@.e@@e...@@e.e...ee@...w
.....e.@e..@e..ee@..ee@e@@e@e@......
..e..@ee..e@@e@.e...@e..e@..@.@e....
w.@........e..ee@.@e@ee.@e.@e.e....w
..e....@e@e@...@e@e.e@@e@..e.e@e....
..e@...e..e@.e.@e...@e@.e..@.e.@e...
w..e.......e.@ee@e..e.e.@e.e.@.....w
..........e@.e@e@@.......e@..e.e....
...ee@e...e@e...ee.e@ee@eeee..e@ee..
w..@e.e@.ee@e....@e@..ee@@e@..@ee@.w
..e@e..ee@@ee@e@ee@...@e.e@......e..