33,36
353
353
1000
.........e..e@e@e.e@ee@.............
w...e....@e..e...e@...e...eee..e@e.w
....@.e.e@e.e@..ee@....e..@@@e.@e@..
...eee@.e@@eee@e@@ee@e.@e.ee@....e..
w.e@.e@e.e..@ee@.@e.e@.ee...e@.e@e.w
....e@@e@e@e...e.e..e@e@@....e@.e@..
..e.eee..e@e...@.@..@..@e..e..ee@e..
w.@.@@e..@@e.e.e@e..e@eee.e@..@e@..w
..e.e@...ee.e@e@....e@ee@..e@e@.e...
...@ee.....e@e@.....e.@e@ee.@eee@...
w..e@....e.@e.e@e.ee@e@ee@@@e@@e@e.w
..e@.....@ee@...e@@@e@e@@.ee........
..ee...ee@@..e..@ee.....e..@e.e@....
w.@@e@e@@eee@@ee@e.e.e@.@......ee@.w
..e..ee@@e..ee@.e.e@@eeee@e.e@e.@e..
....e@.ee.e@e...@e.eee.@.e@ee@......
w.e...e@........e.e@.@eee@e@@e.e...w
..@e..e@e..@e@ee@.e@e..@@ee@eee@@e..
...........e.e@..e@@e.@ee@e.e@@.e...
w......e....e@..ee@e..e.@....@ee@e.w
..e...e@..e@e..e@e@e....e@e..eee@@..
..@e.e@e...e@.e.e@ee..........@@ee..
w.@e.@e..e@e..@ee@@@e.....e..eeee@.w
..e....e@e.......eee@.....@..@e@@...
..@e...@......e.e@@@e.....e..@e.e...
w..@..@e....ee@ee@e@eee.....ee.....w
...e.ee.@ee.@e.@e...e@@e....@e..e...
..ee@@..e.@e@@e@e.e@@@ee@@e@....@e..
w.@@ee@e@.e@eee....eee..ee.e....e@.w
..eee.@e@e..@@@e...@....@..@........
..@@@eee..e.ee.@ee@e....e..e....e...
w.ee...@..@.@e..e.e@....e@.e@...@e.w
..@e...e..ee@e@e@.e@e....e.@e.......