33,36
372
372
1000
..e..e@e..@eee@ee@.e@e...e@@e.......
w.@e..e@e.e.@.ee@ee@@e@e.@eee......w
...e@...@e..ee@@e.e.e.....e.@....e..
..eee.......@e...e@e@....e@.e...e@..
w.@@e.e@ee@@e........e@e@e...e@ee@.w
..e...e@@.ee....e..e@....e....e..e..
....e@eeeee.....@e..eee..@@e@e@..@..
w..@e.@e@@@e.e@.e....@@e.eee@@.e.e.w
...e@@e@ee@...e.@e@e.e@.....eee@e@..
...e@e..@eee..@e@e@@e.e..e@e..e@@e..
w..e@....@e@@e.e@ee@.ee..e@e..@eee.w
..@ee....e..ee.e@@ee@@@.e@e@...e@@..
..e......@ee.@e.e.e.eee@e.e@...@.e..
w.......@e.@e..eee@.@..e@.ee...e@e.w
........e.....e@@@eee..@ee@..e@.@e..
...e@e.e@.e@...@e.@@e.ee......eeee..
w...e@.e@e@e...e..e@ee@@......e@.@.w
......ee@e@ee@e@..e@@e.e....ee@..e..
.....e@.e@....e..e@e.e@.e...@e@e....
w........@e.e.@..@e..eee@.e....e...w
...e.ee..e.e@.e.@e@.e@@..e@e..e@e...
...@e@@e...e@ee.e...@ee..@@e..@e.e..
w....e@e..@ee.@e....@e@.eeeeee@@.@.w
.......@@eee@.e..e@.e.e.@@e@@eee.e..
...e.eeee@@e@e@..@ee..@ee@e.e@...e..
w..@e@@e..@ee@..e@@@....e.ee@e.ee@.w
..@e..e@.@e@.....eee..ee@.@ee@.@.e..
..e...e..e..ee@e.e@.e@@@..ee...ee@..
w.@e.e@....e@@...@e..eee.e@@e.e@e@.w
..@e..e@e.e@.e..e.....e.ee@e.....e..
..e.....e@e..@e.@eee@e@.@.e@.e@ee@..
w..e@e.ee@.e...@ee@@e...e.e.@e@ee@.w
..e@e..@eee@e@ee..e@e..e@.@ee@...e..