33,36
365
365
1000
..e.ee..e@e@eee.......e.@eee@@ee@...
w.@.@@e.e@ee@@@e.eee..@.e.@eee@.e..w
..e@e@...e@e@e...@@@e.e.@e@@e....e..
.....e..e@..@e@.@eee@@e@e.e..e..e@..
w....e@ee@.@eee.e..e@e....@.e@e@...w
.....@ee@e.e@@...ee@@e....e.e@.e....
..e@e..@ee@.@e@..@e.e.....e@ee..e...
w.e.......e.eeeee@e.....e@ee@...@..w
..@@e....@ee@@e@e@.ee@ee@.......e...
..ee..e@ee@..e..ee.@e@e.e@e.eee.....
w.....e@eee@@e..@...e@e.e@ee@@@@e..w
..e.e@..e@.ee...e....e@..@e@.eee@...
..@..ee@e..@..e..e@..@@e@e..@e......
w.e..e....@e.e@..@e.@eee@@e.e@.....w
..@@e@e...e.e@...e.ee..ee@e.ee@.....
..eee@@...e@@...@ee@...@e@e.@.e@@e..
w....ee..eeee...e@..e@e@e@.ee..ee..w
........e@@@e@e.e.e..e@.@e.@...e....
........@eeee@.e@.@.....e@.e..e@@e..
w...e..e@@.@ee.@e.e.....e@e..ee@e..w
..e.@e.eeee@ee.e@...@e..e@e.e@@.e...
..@e@e.@e...e@.e@e..e....@e..ee.@e..
w.......e@e@e@ee@..e@e...ee..@.e@e.w
...@ee@e@...@.eee.e@e@...e@..e..e@..
..ee..e.....ee@@@e@..e@....ee@e@....
w.@e@e.@ee@eee@e.@ee@@e...e@..@e...w
...e..ee.e.e@@@e@e@.e.e......e@.....
..e@.e@..@e@.eee@e...e@e@e....e..e..
w..e@e@e@e@.ee.ee@...@ee@....e.e@@.w
..e@ee@e@...@@e@@eee@e..e..ee@e.ee..
..@.....e..@ee@@e.@ee@....e@@e......
w.eee......e...e..e@..ee...@e@e....w
..e@@e...............e@@e@ee..@e@e..