33,36
370
370
1000
...@ee@e@e...@ee@@e.....@e.e@.e@....
w..e@ee...e..e.eeee@@e@ee...e..e...w
...@e@.@ee@...e@ee.ee..........e....
.......e@.....@.@@..@e....e..e@@e...
w.....e@......e@ee.e.ee.e@@e..e....w
.....e...e....e@e@.@.@@e.e@e........
....e@e.e@.ee.@e@e.e.e@e......@e.e..
w.ee..@...e@@e@e.@e......e@...eee@.w
..@@e.e..ee@ee@....e..e...ee..@@@...
..e@@e..e@e@e.e@e..@..@e..e@@eeee@..
w..e....e.e@e..e@..e..e..e@@e..@ee.w
.....@e.@e.@ee@e....e@@e..@ee@e.....
.....e...e.ee.e@.@e..e.e..e.e@e.....
w....e@ee@..@e..@e....e@....@e...e.w
.....e@e...e@@eee.ee..@ee.......e@..
...e@.e@@ee.e@e@.e@@e..e@...e@......
w.@ee.e.ee@..eee@ee@e@e@@e..@e.....w
..e@ee@e.@e.e@@e@eee@e..e.e@e....e..
...e@.e@.e@..e@@ee@@e..e@@e.e@ee.@..
w..e@e@.e@....ee@......@ee..@ee@ee.w
...e@e@...e@eee@e.e@e.e@@......e@e..
...e@.e.@e.ee@e@@e@.e@.ee@e...e@.e..
w.e.e...e@.@...e@....e.e@.@e.ee@e@.w
..@@ee...@ee....e@.....e..eee@@.e@..
..eee@@e.ee@....eeee@e@@ee@@e@e..e..
w..e@ee@.@@ee@e@@.@@e.e..e@e....e@.w
....e@e.@e.@@e.ee.e@e@e....e...ee@..
...e@e..e..e..e@...e@.@e..e@e@e@@e..
w...e@e.e@e.e@e@e....e@.e..e@....e.w
....ee@e@ee.@ee@@.ee.@e@@e.@ee...@..
....@@e@.e@....eee@@.eee...e@@.eee..
w..@ee.e.@e.ee..ee@ee@@..e...ee@@e.w
...e..e@e@ee@@ee@.e@..e.e@.....e@e..