33,36
355
355
1000
..e@@e@ee@..@e.e@.e....e.......@e...
w.eeee@e.e..e.e.e.@e@e@@eeee@e@e.e.w
..@e@@e.......@e....e.e.e@@e....e@..
..ee...e@.....e@..@ee....e...e@ee@..
w.@@e@e@e..e...e.ee.@ee@e@@e...@@e.w
..ee@ee..e@@e..@.@.e@@e.@@e@..eee...
.....e@e.@e....eee..ee..ee..e@@@@...
w...e@e...e....@@e@e@@e.@e..@eeee..w
..ee..@e.e@....e@e@@@ee.@e...e@.....
..@@e@ee.@ee.e....eeee@.e.e......e..
w.e@...@ee@@e@..........@e@.....e@.w
...e..e@ee@.e@.e......e.ee@ee.e@e@..
......e@e.e.@e.@.....e@.e@.e@.@..e..
w..@e.e@e......e@e..ee@e...e@ee....w
...e@....e@e@.@e....@e.......e@.....
...e@e.@e..@e.e..e..e@eee..e..@e....
w..@e..e@....e@e.@e.e@@@@ee@.@ee@e.w
..e@ee@e.@e.e.e@@e..@eeee@ee.e.@e@..
..e@....eeee@e.@e....@e.e@@@e@..e@..
w..e...e@@@e.@ee....e@e@.ee@e@e.@e.w
.........ee@@ee@e.....ee..e...@e.e..
..e@.e..e@e@ee@..e@..e@@e@@e.e@@.@..
w..e.@..e@e@e..e@.e....@ee.@..eeee.w
.....ee..e@@e@e@e.@e@e.ee..eee@.@e..
.....@@e..eee..e@..e@e..@..e@@@ee@..
w.e@ee@e..@e@e@e.....@e.e@e@.ee@...w
...@e.e@.e...e@@..e@e...@e@e..@e.e..
..ee.....@...@eee.@.....ee@@..eee@..
w.@@...@eee.e.@e@.e......@ee.e@@e@.w
..ee...e..@e@e..e@.......e@e@e..ee..
....e@...e@..@e.ee..e.e@........@e..
w..@ee.@e.e..@ee@...@.@e.e@.....e@.w
...e...e.....ee@e...e.e@.@e.........