33,36
373
373
1000
.....e@e.e@@e@..e...e..e.e.e@e.e@...
w....@@e..ee.ee.@e..@e.@.@e@e...e..w
..@e.ee...@@ee@@ee.e..@e.e..@ee@e...
..e....e@eee@.@e@@e@..ee.@e.@e...e..
w.@.e.e@...@e.e.e@e@..@@ee@.e..e@@.w
..e.@e.ee..e@e.e@e@e..e.@e@....@ee..
...e@ee@@e..e@.......e@e@ee.e.@e....
w.....e@e@.......e@..@e..e..@ee..e.w
..@e.....ee@..ee..ee.....@e@e...e@..
..eee....@.eee@@e.e@e..e.e@.ee......
w.e@@e...ee@@.....@e...@...e@@..ee.w
..@e@e@e....eee..e@....e.....e@e@@..
..e.e@....@e.@@ee.e.e...e@e.e.e@ee..
w..e@@eee.ee.e@e@.@.@.ee.e@e@@ee@e.w
..@e.ee@@e.@.e@..ee.ee@@e@ee.e@@e...
..e@.......e.ee..@@eeee@ee@@@e......
w..ee.e@e...e@...ee.@@e@ee@ee......w
....@.e@@e......e@@ee@e@..e@@...e@..
...ee..e@e..ee..e@e@...e..@.ee@.ee..
w..@e..@.eee@@ee.e...e.e..e..@ee@..w
.......e@@@...@@e.ee.@e@.e@e........
......e.eee.e@e.@e@@ee.@e.e@e.......
w.e...@e@e@.e@e@@ee....e.e@.e@e@.e.w
..@e.e@@e@.....eee@......e@e@e.ee@..
..ee@eeee@@e......@e.e@..e@@@eeee@..
w.@e@e.e@ee.e@....e.e.e...eeee@@.e.w
..ee@e.@.ee..e....e.@e@.....@e@ee@..
..@.e@.ee@@e.e.e..@e@@e..e@.e@e.....
w.e.e...e@e.e@.@e@e@ee@...e.@e@e@e.w
....@ee.ee@e@....e..e@@e.....e@e....
...e@e@e@e.......e@e..e@..e..e@.e@..
w..@e..ee@..eee@e...ee.e@e@...e.@e.w
..e@e.e@@e.e@@e....e@@e.............