33,36
351
351
1000
..@e...e@.....@e....e@e.e@e@e..ee@..
w.e.....e.....ee@e......e@.....@@e.w
..@e....@..e@e.ee.eee....e..e@ee....
........e..@e.e@@e@@@e...e...e@@....
w..e..@e.......e@eee.@e..@.....ee@.w
..e@..e@@e....e@.e@e@....e@e...@.e..
..e@.e@.e....e@e.e@@ee....e.e..e.@..
w..e....@..e@.e@e.e..@....@e@e@e.e.w
......e@e..@eee@@e@..e@e..e@ee@ee@..
...e.e......e@eee@.........e@.e@@...
w..@e@.e@...e.@@e@e@..e....@e..@e@.w
..e@e..ee@e.@@e@@.@ee@@@ee@@e@eeee..
..e@@..@.e@.eeeee....eee..ee..@.@e..
w..ee.ee.@e...@.......@e..@e@eee@e.w
......@@@e.eeee..........e.e@..e@e..
..e...eee.e@@@ee@ee.e....@e@e..e@e..
w.@e@e.e..@ee..ee@@.@e..e@...e.....w
...ee@e@e.e@e@e@@.e..e.@ee@..@ee@e..
...@ee@e.ee.@e..e....@ee@ee....e@...
w.....e@e@@.e@.@e.@e..@e.@.....@e..w
..e...e@@@e@..@e..e@e....e.e..@ee...
..@e...eee.e@ee.....@e.e..e@e.ee@e..
w..@.......@@e.e...ee@.@ee@@e...e@.w
...e..ee@e@ee..@eee@......@e@.......
..@e@e@@@e..e@..e@@e@e..e@eee.......
w.e.ee.eee...e.e..@e.e@e@e@@@ee.e@.w
..e@.@e..@...e@@e.e........e..@..e..
...ee@..ee.e@@e.@..eeee@e....@e@e@..
w.e@.e@e@@e.e...e.e@@@.e@..eeee@e@.w
.....e@.e@e@e@ee@.e@ee.e@ee@@e@..e..
..e@@ee.@e.e@.@....e@@ee@@...@e.....
w..eee@.e@@e.@e.ee@@....ee.e..@e...w
..........e@.e.e@.ee....e@.@e.......