33,36
371
371
1000
..@ee@ee@e@@e.@e@e............e@e...
w.eee@@ee.eee.e..@e@e...e@...e.....w
..e@.e.e@.@e@e@e@...@.e@@e..e@eee...
......e@@ee.e@e.e.@ee..ee.e.@e@@@e..
w.ee.e@.e@@e@e.e@.e@e@ee@e@e@e.e@..w
..@@e...@.ee@@e@e@e.e@e...ee@e..e...
..e@ee@ee...eee@e@....@e.e@@@e......
w.e@.e@e@....e@e.ee.e@.e@.@ee@.e...w
...ee@...e...@@ee@@.@e.@e.e.e@e@....
..e@e....@..eee...ee@e..e@e....e....
w.@.e...@e@e@.e@e...@e.e@......@...w
..ee@ee.e.e@.ee@@@e@e.e@@ee..@ee....
...e@@@e.e@..@eeee.e@e@eee@..e.@....
w.e.eee..e@..e...e.@ee@@ee@e.e.e...w
..@ee.@e@.e.e@...@e@@.e..e...@..e...
..@e@.e@e..........ee.e..@e..e.e@...
w.ee@....e...........e@..e@..e@@e@.w
....e....@e....e......@ee@.e@ee@.e..
..e@......e....@e....eee@...e@.ee@..
w.ee..e@ee@..e@@e@.ee@e@.e..e......w
..@e..e@e.e...ee.e.@e@@e.@e.@..eee..
..e@...e@e@@e.....@e@e..@e.eee.@@@..
w.e@e......e.@e...ee@..@e@e@e@.eee.w
...e@ee..e@e.e..@e..e.ee..@.@@e.e...
..e@e@@.e..@e...e.e@e.@ee@e.ee..@e..
w.e@e@ee@.@e..e......e@e.@ee...e@..w
..e@...e@@e...@.....e....ee@....e...
...e....ee....e..e.e@ee@ee@e........
w.@e.....@e...@ee@e@@e@...e@..e.e..w
..e...e@ee@@e.ee@ee@e@........@e@...
..e@e.@e@..e..@e@@.@ee.ee@e...ee@e..
w.....ee@e@@..@eee@ee@e@.e.e@ee@...w
...e@e.e@eeee@e....e@e..e@..e@......