33,36
354
354
1000
....@e@@e.e@@e@..e@.@e..ee@.e@e.e@..
w..ee.ee@..ee.e...e.e...@eee@@e..e.w
..e@.e@@e@e@.......@e.e...@e.e......
..e@e@........e....e..@e@..@e@......
w....@e@e..e@e@.......eee....e@e...w
.....e...e.@@e..ee...e.@e@.e@@e.e@..
..@e...@e@.eeee.@@e..@e..e.@e.e..e..
w.e.e@ee.....@@.e@.ee@e@e...@e@....w
.....ee......ee.@e.@.ee@e..e@e.e....
..e.e@@.ee..e@@e@@eee.e@e.e@..e@.e..
w.@...ee@@e.@@e.e...@e...e@@e...e@.w
..e..e@@ee..ee.e@@e.@e@e.eee....@e..
..eeee@..@e....@ee..e@e@e@@.e..e@e..
w.@@@@e@.@e......@e...e@e.e.@...@e.w
..eee..e.e.e....e@e@e..@ee@.e.e.e...
....@e.....@ee@e@@e..eee....@e@ee...
w.e@......e@@ee..e@e@@@e@...e@e@@e.w
...e.......e........eeeeeee.e@e@e@..
...ee....@e.ee......@e.@e@@.@eee.e..
w.e@@....e.e@@e.....ee@e@ee.@e@@e@.w
..e@eee.ee.@e@....e.@....@e.ee......
..@e.@@e@@e@.e@e..@.e...ee@..@e.....
w.e@.e@e..ee...e..e....e@@e.....e..w
...@ee@@..@@e.e@.e..ee...e..e@@e@...
...e@.ee@eee@...e@e@@@@e.@e..ee.....
w.......e.@e@e@e@@eeeee@.....@.....w
...e..ee@......e@e.@@.@......e...e..
..e@..@e.e.....e@..ee@e..e.e..e.e@..
w.@e.....@e.....eee@@e@..@e@e@@e.e.w
...@ee...e.e@e...@@@eee@ee..@e@@e@..
..e@e@..e@.@e@...eee.@e....@e.e@e@..
w.ee........e@e..e.ee@@eee.ee@e.@e.w
..@e@e@e....e@e.e@e@.e.e@@e@@e......