33,36
369
369
1000
...e@.e@e.@e.e@eee..ee@e.e..e@e@e...
w..@e.@e..e....e@@e.@@ee@@...ee@e..w
....e@....@....e@e.ee@e.ee...@e@ee..
.....e...@e..eee@e.@e@ee@eeeee.ee@..
w.@e..ee@e@.e@@e@@..@e..e@@@@e.@e..w
..e..e@....e@ee.ee...e@ee@ee........
...........@e...@....e@@e.@@........
w....e.e@ee@@e@eee@...e@e@ee.......w
..e.e@.....ee.e@..e.e..ee.e@@e@e....
..@e@....@e.@e...@e.@eee@@e.ee@e....
w.e@...e.e@..ee..e@..e@@.ee..e@ee@.w
.....e@@e...e@@..e.@e@.e..@......e..
..e@e.e@e@.e@ee..@eee.@e..e..e@e.@..
w.e@eee@eee@@e...e..@ee...@e..e@.e.w
....e@e@e...e@...@e...e.e@ee..@ee...
....@ee@@e..@e.e@.....@eee@@e...@e..
w.....@e.e@e.@e.e......e@@e@e..e@e.w
.......e@e@ee@.........e@@ee........
..e.e@eeee@.@ee@e...e...ee.@e.e.....
w.@e.e@@e.e..ee.e@..@@eee.@e..@..e.w
..@e@e@e.e@ee@@..e.eeee@@ee.e@e.e@..
..e.e.e@e@..@ee...e@@e.e@@@e.ee@@...
w....e.e@e..e@e...@e...@eee@e@eee..w
...ee@e@e....e@...e@.e@e...e@e@.@...
..e@@@ee@@e...e@e...@e........e@e...
w...ee.e@e....e@.e..e.@e@e@e.@e....w
...ee..@e.e....e.@e...e.ee@e.e@e@e..
...@@ee@.e@e@.....e@e.@.e.@e.....@..
w..e...e@e@@e...@ee@@ee.@.e@@e.e@e.w
...@e@.eeee...e.e.@e.@@ee...e...@e..
.....e@@@@e.e@@....eee@e@e.e@...e...
w..e..eee....ee...e@@@@ee@@e.......w
..e@e@ee@...e@....@eeee...e@........