33,36
353
353
1000
....e..ee@e...e@e..e@e@@e..e@e...e..
w.ee@@e@e@e@e@ee....e.eee...e@..e@.w
..@e.e@.ee@e@.e@..e.....@e.e.@e@e@..
..e..@ee@ee......e@e...e@@e@.e..@e..
w.@ee...e@@e...e.@e...e@e.@..@e....w
..e@@..@e....ee@.....e@@e.e..e......
....e..e.....@e@e@...e@e@.@e@@e.....
w.........e@e..e.e@ee.....e@e..e@..w
......e@e.ee@..@.e.e@@e...e@e...e...
.......e@e@@@eeee@..@ee@e..@e..e.e..
w.e......e@ee.@ee@e@e.@.e..ee.e@e@.w
..@e@e...@..@e.@.@e.e@e.@..e@e@e@...
..eee@.e.e...@ee@e..@...e..e@@......
w.@@@e.@ee@ee@.e@e@eee@ee@e@ee.....w
..eee@e@e@@e.e........e@..@e.e..e@..
...@@e.e@@e.e@@e..e@e.e@...@.@@eee..
w..eee.e@e....e@....e.@e...e.ee.@e.w
....@@e@....ee....e.@e@@e@e.....e@..
....ee@.....@@..e.@.e@eee.e@e.e.....
w.e.@@.e..e.ee.e@@e....e@ee..e@....w
..@eeee@.e@.@e...e.@eee@@e@.....e...
..@e.....e@.e@...@.ee@@ee..e@ee@@e..
w.e.e.....e......e..e@ee..e@@e@ee@.w
..@e@@e.e@e.e@e..ee..e@@.e@.ee.e@...
...e@e...ee@@e.ee@@e..@e...e@@e.....
w.e..e@ee@@e@..@@@e...e@@e..@ee....w
..@ee@e.....ee@eee@ee...e.e@ee@.....
..@e..@e.........@e@@e@ee....@@e@...
w.ee..@ee@ee@e...@e@e.e@@e.e@ee.e..w
...@e.e..e@e@e@e.e..@..e@e.e@e.e@...
....@....e.e@..e@e@eee@.e@..........
w..ee....@..e....e@..@e.e.@e....e@.w
...@e....e........e..e@.@ee......e..