33,36
367
367
1000
......e@@e.ee@..e..@e.....e@@ee@e...
w...ee.eeee@.ee@@..e.e..ee@ee.e@...w
...e@@e.e@e@e.@eee@e.@e.@@ee...e....
....e@e...@e@e.e.......ee..@e....e..
w...e@@ee.ee@@e@@e..ee.@ee@e..@ee@.w
..e.@e.e@..@eee@e..e@@e@@e@@e.ee@e..
..@e...e...........@e@@e@ee@e.@@@e..
w..@ee@@ee@e..@ee@ee.e.e@e@@e@eeee.w
....e.e....@e.e.@@e.e.e@e@.e..e.e@..
....@e..e.......ee..@..e..e@..@e@...
w..ee@e@@ee......e@ee..@e..e@ee@@e.w
..e@...e..@@e@e.e............@e.ee..
..e@e.e...ee..e@@..e@e@...e.e@e.@@..
w.@e..@.@e...e@ee@e@e.ee@e@e....ee.w
..@ee@e@e.@e.ee@.ee@eee@.e@@e.......
..e.e@e..@e.e@@e.@e@@@e@e@e@ee..@e..
w...e@e.@e..@ee@...eee@e@@e..@e.e..w
...e@e..ee@e..........@e.e.....e@e..
...@..e.e@@eee@e..e...ee@e....e@.@..
w..e.e@@e.ee@.....@e..@e....e....e.w
......@e@...........e.....e.@e..e@..
..@e..e.@e@e@e...e@e@@e...@e@ee@ee..
w.e.....e.e@@e.e.eee@e.@e@.e.e@ee@.w
..e......e.@e..@e@@e...e@ee@.@e@....
..@e..e..@ee.....e@e.....e.@e....e..
w.e@.e@.....e@e..e@e...e@@.e..e.e@.w
..e.e@...e@e.e@e....e...ee....@e....
..@e.........@.@.ee@@e...e.@e.......
w.@e.e@e...e.eeee@.e@e...@ee@@e....w
..e..@e@..e@ee@.e@e@e@e@..e@eeeee@..
..e@..e@e.e@@ee@e@.@e..ee...@.@@ee..
w..e....e@@ee@@e@e.e@.ee@...e.e@e..w
.........e@e......e@.e@e@e..e@e.....