33,36
354
354
1000
.....e@.ee@e@@e....e@@e....@e.e@@e..
w.e.eee.@..eee......ee.ee..e@.eee..w
..@e@@e@e@e@@.e@e....e.@@e.e@e@@e...
...e@e@..e@eeee@e...e@.e@e.e@e@ee...
w.@ee....@e.e@e@e...........ee@e@e.w
..ee...@ee@.@e@..e@.@e..e...@e..e@..
..e@@e.ee@@e.....@e@e..e@...@e@ee@..
w.e@e.....e@@e......@e@.@e..e.e@.e.w
..@e.e......e@e@..e...e.e....e@..e..
....e@ee@e....@e..@e.@e.@..e.....@..
w.....@e.e...e@e.e@e.e..e.e@..e..e.w
..@e.....@ee.e@e........e.e@ee@@e...
..e.e...e@e@.e@e.ee..e@e@.e@@@ee@e..
w.@e@.e.@e.e@.@ee@@@e..eee.ee@e.e@.w
..@e..@e@.@ee.e..@ee..e@@@e.....e@..
..e.e@e.e.e@..e@ee......ee.e@e..@e..
w.....e@e@@e..e.@e.......@.@e@.....w
.........e@e..@ee@e@e...ee.ee@e@e...
..ee....e.@e.....e@....e@..@e@ee@...
w.@@ee.e@@e............e..e@ee@....w
..ee@@e@.eee....e@e...e@..@@ee@e@...
..e.e@e.@e@@e@e.e.@.e@@e.@ee..e.e@..
w.@.....eee@e..e@@e.@e...e...e@.ee.w
..e.....@@e....@ee......ee.ee@@e@...
.....e@ee@@e.e@@e.@e@..e@@e@e@ee@e..
w...@ee@@ee@..ee@.e.e....@e...@ee@.w
....e......e@.e@...e...e.e@.@e@.@...
.........@e@eeee..e@..e@.e@ee.e.e...
w....e.e@e@e@@@@e...@e........@@e..w
....e@e@@e@e@ee.@...e...e.e@..eeee..
....e...e....ee@e...@..e@e@e.e..@@..
w...@.e..e@@e@e@ee@.e...e@...@..ee.w
....ee@...ee.e@...e.@e@ee@e..e..@e..