33,36
362
362
1000
....@e.......@e...e@..e@e.e...e.....
w..@e....e@e.e.....e..e@ee@@ee@e@e.w
...ee.ee@e.@e.........@e.e.e.@e@e@..
...e@.@@e.e@.e..e@e@e.@ee@.@ee...e..
w..@..e@e..ee@......e@e.....@e@ee@.w
...e..e@@e.@....e@e....eee....e@e@..
..e@...e@@ee.....e@...e@@@e.....@e..
w...e@e.e..@ee....@e...@e...e..e...w
..........ee.@....e@..@e@...@.e@.e..
....e@..e@@@.ee@e.....ee@e..e.e@e@..
w...@e...eee@ee@....@ee...e@@e...e.w
..@e.@..ee.ee@ee.@e.e.@....e@e@ee@..
..e..ee@@@e@@@e.@e.e..e...e@..e@....
w.@e@.eeee@.eee.e..@eee.e.@......e.w
..e.e.@e.e@ee@@ee@e@e@@e@.eee@e.e@..
......e@@e@e@..e@e.ee@e@@e.@e...@e..
w..e..e@e@...ee@@ee@@...e.e@e@...e.w
...@e@.....e.@e@e...ee@e.....e..e@..
..eeee.e...@e....e@e@@e...e@e..e@e..
w.@.@.e@e@....e@e@..e@e@e@e........w
..e.e.e@@e..e...e@e.e.@.............
..@e@@ee@ee.@e.e@@e.@eee@...e.......
w.e@.e.ee@@e..@e@ee@e...ee@.@@e....w
....@ee@.e@e..eee@e@e....@e.eee@e...
....e@ee.@@e.e@@@e@........ee@e@e...
w...e@@@eee..e.ee.e...e@e.e@@e@@e..w
.....ee....e@@e@..@....e@..@e..e@...
..e....e.e@.e.e@e.e...e@ee.e..e.@e..
w.@eee@@@eee@..e...e@e@ee@....@@e..w
...@@.eeee.e..e@..e@.e@@e@ee@eeee...
..eee..ee@e@...e@.....ee@..e..ee@...
w.@e@.e@ee@.e...e..e.e.@e.e@@e@@...w
...e@e.e@..e@e@e@.e@.@e.e@e.e..e....