33,36
354
354
1000
......e@@e.........e..e@e@.@e.......
w.....@ee.e@e..e.e.@e@.eee@ee@e.@e.w
..e@e..e@ee@e.e@e@...e@e@...e@@.ee..
..e...e@e@.e..e@@.e..e@ee@e@eee@.@..
w.@e@e@.e.e@.e@eee@..e.......e@e.e.w
..e@....@e@..@e.@e.@e@.....e@@ee@...
..e@e...e.e...ee..@e.e......e@e@e...
w..e@..e@e@@ee@@e.e..@e@e..........w
...e@ee@e@@e.ee@e.@ee@e@ee.e........
...@e@@e..e@e@@eee...eee@@.@e..e....
w.....@e.e@..ee@@@e@e@@@eee@e.e@.e.w
....e.e..e@e.@e.e..e@@ee.e@@e.ee.@..
...e@@e.ee...e@.@....e@@e..e..@@ee..
w....eee@@e@.e..e.e.@e........e@ee.w
..e@e@@e.e.e.@ee@.@ee@..e.....@..@..
..eee.e@.@..e@.@..e@ee..@.....e@.e..
w.@@@eee@e...e.e.e@e@@e.e......e...w
..ee@@@@.....@e@e@..................
....eeeeee...ee@e@e......@e...@e....
w.@e....@@ee.ee@e.@e@.@e.ee@..e@...w
..e....ee..@e@@e....e.e..@ee...e@...
......e@...ee@.e.....e@....@e...e...
w..ee.e@...@@ee@.....e...e.....e...w
..e@@e@e...e@@e@.....@..e@.....@e@..
..ee@.e....ee@ee@....e@e@e...e.e@e..
w.@@e.@e@e.@e@eeee...ee..@e@e@..@e.w
..e..e@e@e.@e@e@e@e@.@@e.ee@e@e.e...
....ee@.@eeee...e@@e.e.@e..ee@e.e...
w..e@@e.ee@e@...@e..eee@....@e.e@..w
...e@@e..ee@....e..e@@.eee@e@e......
...@eeee.@ee@e@e@..e.e..@e@......e..
w....@@@.ee@e@..ee.@......e.....e@.w
.....eeee@@e...e@@ee......e@e....e..