33,36
367
367
1000
.....e@ee@e.e@@e.e@..e@e......e.ee..
w..e.@@e@...@ee@.@e..e@.e.....@.@@.w
...@.ee..e.ee@...ee@e.e.@e@e..e@ee..
...e....e@e@....e@e@.e@ee@@ee@@.....
w..ee.....@@e...@e@ee@e.e@e..ee....w
..e@@.e@eeee@...@e@e@.e...e@@e..e...
..@@e...e@ee.e@ee.e@.e@e@e.ee..e@...
w.eee...ee@@.e@e..e@...e....@e.....w
..e@@e..@@@eee@e..ee...@e..e@ee@@e..
..e@@e..eeee@e@.e.@e..e@@ee@@e.ee...
w.@eee...e.ee.e.@e.e..@ee@.@e@..@e.w
..e@.@..e@.@@e@e@.e@..e...@e.e......
.....e...e.ee...e.ee..@ee@eee@e@e...
w.ee.....@e@....@e@@....e@e@@e..ee.w
..@@eee@e@e...e@e..ee.e@@e.e@e.e@@..
..e.e@e.e@e.e.@ee@e@@e.e...@ee@..e..
w.e@@e.e@e@e@..............@e@ee@e.w
...ee@e@...@e@ee@ee......e.ee..@e...
......@e....e@ee..@ee..e@@ee@e@e@e..
w.ee.......e@..@..ee@e..e@ee@ee.e@.w
..@@e@....ee@e.e@e@e@@e.@e.......e..
..e@.e....@ee..@e...e..e@e...e@.e@..
w..e...e....@@e@ee@e@e@@eee@e.e.@e.w
..ee...@ee.eee..@.e@..e@.@.e........
..@@ee.ee@.@e...e.@.e@.e.e.@..e@e...
w.e.e@e@e@.@e...e.e@eee....e..@ee@.w
..@e@.ee.e@e....@e.@ee@e...@e....e..
..e...@@e......e@e.e.@e@eeee....e@..
w.@e..ee@.....ee@@e@.e.e@@@@....@e.w
..@e.........e@ee@@@eee@@eee@..e@...
..e..@e.....e@...eee@@..e...e..ee...
w....e......e.e..e@..e......@ee@.e.w
............@e@..@e........e@e..e@..