33,36
366
366
1000
..e@e.......e@e...@ee@.e@e@e........
w...ee......@e...ee..e..e.e.@e..ee.w
....@@e@...ee@...@e...@e.e@@e@..@@..
..@eee.e..e@@.....@e..ee...eee@@ee..
w.e....@e.@ee@e@..e..ee@.ee@@@ee.e.w
..e@...e@@e@e@ee..@@e@@ee@..e.@..@..
...e..e@ee...e@e..eee@@ee@e@e.e..e..
w..@..@.e..e@@@e@e...ee..e.@e......w
..@e.eee@e@eeee.ee@e..e.e@ee....e...
..e..@ee...e..@.@.e@e.@.e.@e.e@e@e..
w.....e@@e.@e@e.e@@e.eee@.....e@e@.w
..e@..e@eee@e@.e.e...@.@@ee.ee@@e...
...e.e@..@ee.e.@...e.e.ee.@e@..ee...
w..@e@.e@e...@ee..e@........e.e.@e.w
...e@e.e@....e@..e...e......@e@@e@..
...e.@..e...e@.ee@.e@@e..ee.e..e....
w.e@.e......@.e@e...ee@.e@@...ee@..w
.....ee@e...ee.e@....@e.e@e..e@.e...
..eee@@e....e@...e@e..@..e@e@@e@e...
w.@@@e@e...e@e@@e.....e@.@eee@e@...w
..eee..@e..@e.ee.e@..@ee.e@@ee.e....
..e@@.e@@e.e@..e..e..e..e..e@@e.....
w...e.@e.....e.@..@ee...@e....@e...w
...e@@ee.e.e@@ee..e@@e..ee@..e@@ee..
...e@e@@e@..e.@e@ee.e@.e@.e...ee@@..
w....e@e......eee@@ee@e.@e...e@@ee.w
......e@.e...e@@e..@e.e@ee...@ee@...
...@e@e@e@..e.e@e..ee@e@@@..@e......
w..e...e....@ee.@ee@.e.eee..e....e.w
..e..e@@e@e@ee@e@@ee@..e@@e...e@e@..
..@...ee..ee@e@@ee@.ee......eee.....
w.e.e....e@@e.e.e@e@e@......@@@e...w
....@e....e@ee@.e@e..e@e@e..eee@....