33,36
342
342
1000
.......e...e@e@....e.e@e.e@@e@@e....
w......@ee@@e.e@e@e@.@e@..ee.ee....w
......e..ee@.e...eee.....e@.ee..e...
...e@e@..@eee@...e@@e@......@@ee@...
w.e@.@ee@e@..e...e@e@e.e.@eeee.e@e.w
..e@e.@@eee..@e.......e@.e.@.@@e....
......e@e@@.ee@..e@e..@e...e.ee.....
w....ee.e@ee@.e@e....ee@.@e.....e@.w
..e@.@@.@e@@e...@e..e@.@ee.@e.@e.e..
..@e.eee..e@eeeee...e@.e.@ee@.e@....
w...ee@@e.e@e@@@@e@e.e.@ee@....ee@.w
...e@@e..@eee@eee.e.ee@e@@e.e.e@.e..
..@ee....ee@.@e@e@@.@e@ee@@e@.@e.e..
w.e@@e.......e@..ee.ee@e.ee@.e@@.@.w
....e.ee@eee.@e@.@ee@@e......@ee.e..
..e@@e@@ee@@.e.e@e@e..e.e...........
w.ee..e@@e@e.@e@e..@..@.@e.........w
..@e...e@.e.....@e.e.@ee@..e@@e.....
..@ee@eee@@e....e@@eee..ee@eee@..e..
w.e..e@@ee..e@e@e@e@@e.e@@e.@e@ee@.w
..ee........e@@e.............@@e@...
..@@e..e@@e@.e@e......e@...e@ee.....
w.e@e..@ee.e...@e......e..e........w
..ee@.e@...............@e.@e..e@e...
..@e..@e......@e..e...ee.....e......
w.............e...@e.e@@.....@e....w
.......e.....e@...e....e..e...e@e...
....e..@e@e..@.e..@e@e....@e@e.e....
w.e@@e.e@@e@eee@...@......ee@@e@...w
..ee@@e..ee@.@ee...e@e....@@e@e.....
..@.e@e...@ee@e@..e..@@e..e..e@.....
w.e..e.eee@ee@e@..@eeee@.....@e@e@.w
....e@e@@e@e.e@e..e@@e......e@e..e..