33,36
348
348
1000
......e@e...e@e.....@e@ee@e@.ee@e...
w....e...e@e@e@..e..e..e@@ee.@@@e..w
....e@.e@e@@@e.e@@e....@.e@..eee....
..ee@...e@eee..@ee...@eee@...@e@....
w.@@eee@..@e..e@e@..eee@.@e.e@e@ee.w
..e.e@@e..e....e@@ee@@@e@e..@e.@e@..
.....e@e..@ee@e..e@.@e..e@....ee....
w...e@e..e@e..@e....e@..e@eeee@e.e.w
.....e@@e@.....@e..ee.....e@@@e.e@..
.....e@e@....e@e@@e@@e..e@@.ee@..e..
w.....@e@e...@e.@e.e@....ee.@e..e@.w
......e...e...e@e...ee.e.e..e@..e@..
.......e@e@.....e@e@e@.@.@e......e..
w..e@...@e.ee..@ee@e.e@ee@e@.......w
....e.e.e@e@@e@e@ee@.e@e@.@e........
....e.@e..@.@e..e@@ee....e@@...e@...
w..e@e@@..e.e..e@.e@@e....ee....e..w
...e@.ee...e@......e@.ee.....e@.@e..
....ee..ee.....@e@e@ee@@ee@...e.....
w.e.e@.e@@eee.eee@@e@@.e..e.e@..@e.w
..@e@@e..e.@@e@..ee..e.@ee...e..e@..
...e.e...@eee..e@@e..@e.e@.e@e..e@..
w..@e.e.e@e....@e....@e@e.e@@ee..e.w
..e...@.@e.e..e@@e...e@@e.@eee@.....
..@e@ee..@e@ee.e.e...e.e@......e....
w........e@e@@ee.@..e@@e...@e..@@e.w
.........@...@e@.e...ee@..ee...ee...
..@eee..ee@e.e@@e..ee@...e@.........
w.e.@@.e@@e@...ee..@.e@e.e.@ee.....w
....ee..@ee..e@e@..e....e@.e.@.@e...
....e@e@ee@.e.e@..e@.e@..@e..e.e....
w...@.e.e.e@@@e..@ee@ee@eee@ee.ee..w
....ee@e@.@eeee@ee@..........@e@@e..