33,36
359
359
1000
....@e..e@e@e..........e@e.e@e@ee@..
w..@e...e@e........@eee@e....e@e.e.w
...ee@..@e@..ee....ee@@e@e@..@e..@..
.....e.e@ee..@@e...@@.e...e...@e.e..
w..e....e@@e@e@e@e.ee......@ee@e...w
..e@...e@ee@.e@@...@ee.....e.e@@ee..
..@e..e@......ee..e@@@e@...e@ee@e@..
w.e@@ee@e...e@e@@e.ee..ee.e@.....e.w
....ee@..ee.....e..e@e@@@e..@e..e@..
......e@e@@e....e@e...ee....e@.e.e..
w.e......e@e@...e@e...e@e@..ee@@e@.w
..@......e@.e..ee@@...@@ee.e@.e.e@..
..e.eee@e@e..e.@eee.e@ee...@e..@ee..
w.e.@@ee@@e..@e@@...@....@e.e@.e.@.w
..@.e@...e.e@e.eee..e...eee..e...e..
..e..ee@ee@e@e...@@ee.ee@e@@e.e@.e..
w......e@.e.e@e@eeee@e@e@e@e@.ee.@.w
......eee@ee@e...@@e@.ee@.....@@ee..
.....e@@@e.e@@e..e..ee@@e...e@e..@..
w..e@e.e...@e...e@..e@@e@..e@...ee.w
..e@e@......e@...@ee@.ee@ee@...e@...
..@ee@e.@e@..e...e..e@ee@......@e...
w.e@e@..e.e.........e@e.e..@e@e....w
.....eee.e@@e@e.e@e@@e....ee.e..e...
.....e@@...ee@e..e.e@@e..e@@e@e@@e..
w...ee@e@@e.e@e..e@eee@....e..@e...w
....@e@eee..e@ee..@e.@e...e@.e.e@e..
...e@e@@@@e.e@e@..e@.e@....ee@.e....
w..@e.eee.......@e..e@e.ee.@@ee@e@.w
..e....e..@e....e...e.@e@@.ee@@e@e..
..@e.@e@.@e@....e@.e@.@e@e....e..e..
w....e...e.......ee...ee@eee@e..e@.w
....e@e@ee@e.....e@.e@e...@e........