33,36
347
347
1000
..ee@e@eee@e@e..e@e....e@e@ee@.@ee..
w.e@.e@e@....@e..e@.@ee.ee@@ee@ee@.w
...e.@e.@e..e@e@..@eee@...e@ee.@e...
...@e...e..e@@ee..e.e@...e@.e@e@@...
w.e@.........e.ee@..@.e.....e@eee..w
...e.ee.......e@@e..e.@e.e..@@e.@...
....e@@..e......@e..@.e@.@e.ee..e...
w.e..ee.e@@e@...e.e@e.e..@ee@.e....w
..@e.@e.@eeeee@.ee@e@e@e@e....@e....
..e@e@@e@ee@..e.@@@ee@@e@e..e@.ee@..
w....e..@e.e@e..eee.e@e..@ee.ee@.e.w
........e.e@@e.ee@......e@e@@e@.....
......e@@..@e.e@@e..@ee@.e@.e.@e....
w..@e..ee..e@.@e@e@ee@.e@@..e.ee@e.w
...e@...e@.e@e@.e@eee.e.ee.e@e.@e@..
..e......ee@..e.@e@@@e@..@..e@......
w.@..e...@.e....e.ee.@e@ee..@.@e...w
..e.e@e.@ee@e.....@e..e@....e@eee@..
..ee@@e.e...@e...e@.ee.e..e...e@@e..
w.@e@e@.@e..e@..e@ee@@e...@e@e.....w
..e@.....@e.e@.e@e@.@eee............
........e@e@@ee@..eee@@@ee@e...ee@..
w....eeee..e.@e@.e@@e.e@e@.....@ee.w
....e@@@@.e..e.e.@e@e...@.....e.e...
..e@e.eeee@e.e@e.e......e....e@.@e..
w........e.@@e.ee.......@e@........w
...e@...e@.ee..@@eee@e@e@@e.........
....e......@e@.e.@@e..e@e.....e@e@..
w...e........ee@.e@e@...@ee......e.w
...e@ee...e@e@@e.@e@e..e@@@e.e@.e@..
...@e.@........@.@e.e...eee@.ee@.e..
w..ee.e........e.e..@e..@.e@e@@ee@.w
..e@@e.........@e.e@e...e@e@e.......