33,36
357
357
1000
..e@@ee@.....e@@e..e@e@e..@e.e@ee...
w.eee..e..e...ee@..eee@e..e...ee@e.w
..@e@.....@@ee.@e.e@@ee...e...@.e@..
..e@......ee.@e.@.@e@.@e..@e@.e@e...
w.......e@ee.e..e@..e...e@eee.e.@e.w
..e@@e@..e@@.@..@e........e@@e@e@e..
..@ee@e...ee.e@..e@e.......e@e..@e..
w....e...e@..ee........e..ee@e.@e..w
..ee.@......e@@.......e@e.@e@@ee....
..@@ee.e@....@e......e@@e@e@e@......
w.e..@e.e.e@.e@ee.e.ee@e.e...ee....w
......@ee@ee@.e@@e@.@.e@e@e@e@@..e..
......@e.e@ee@@e@@e@e@e.....e@e.e@..
w.....e..e@@eee.ee.......e..e@ee@..w
...ee.....e@ee@..........@e.@.@@e...
...@@...e.e................ee.e.....
w..ee..e@.@e@..e.@e...e@e@e@.....e.w
..@e..e.@e..ee@@.ee.e@...e@.e...e@..
..e@..@eee...@ee.e@..e.e@e@e@..e....
w....e.e@@e.e@e@e..e@@e.e@@e...@e..w
..eee@.@e@e@e@..@...ee@..ee@..e..e..
..@@@eee.@e..e..e.e.e...e@.e..@ee@..
w.ee@e@..e........@e@....@e@.e@e...w
....e@.....e@e....e@e....e@..e@.e@..
...@ee....@e.@@ee@@e..........e..e..
w.ee@@....e..ee..ee@e.eeee@e..e@e..w
..@..e@e...e@@.@e@e@@e@@@@e.e.@.@e..
..ee@e..e@e.ee.e.eee..@eee@.@ee.....
w..e....e@ee@..@e@@@e.e.e@.e@.@ee..w
..e@....e@e@@e.ee@eee.e.e@e.eee@@...
..e@@e@..e..e...e@e@@e@.e@...@e.e...
w.@ee@eee@e..e@e@@e.e@@e.ee@@e.ee..w
..e...e@@ee@e....e..e@e.e@@ee.e@@e..