33,36
363
363
1000
..e.@ee....ee@e@e.@ee@......e...e@..
w.@.ee@.e.e@e@e...e@.e....e@@e...e.w
..ee@...@.@ee...e@...@ee@e.e@e......
..@e@e@ee.e@@e@..e..e.@e@e..e.......
w.e.e.e@e....@e.....@eee@ee.@......w
........@e.e.e@e.e.@e@@ee@@eee..ee..
....ee.eee.@e@e@e@.e..@e@@e.e@ee@@..
w..e@@.@@@ee..........e..e..@e@@ee.w
.....e.ee@e.....e@eeee@e@e@eee@.....
.....@.....e@....e@@@e@@.e@e.ee.ee..
w....e.....@e...e@@ee.eeee@@e@..@@.w
......ee....eee@e@e@@e@@@.e...@eee..
..e@ee@@e.e@@@..e.e.e@.ee..@e@e.e...
w.@....@e..eee@e@e@..e@e...e....@e.w
..e...@e......e@...e@e@ee@e.@e..e@..
....e.e............@e@.@e.@@ee@.@...
w..e@e..............e@ee@.ee..e.ee.w
..ee@@e@e..ee.e..e@ee@ee..@@e@e.@@..
..@ee..e@.e@@e@@e..e@e@@e.ee@e..ee..
w..e@.e.e@..e@.e@e@...@ee.@ee@@e@..w
..@e.e@.@e.e...@e.e...e.@.....e.....
..e..@@ee..@...@eeeeee..e@.e........
w....ee@@e.e.e@e.@@@@@e.@e.@e...@e.w
......e@@e..@e@..eeee@ee@ee@e@..e...
..e@e..ee...eee....@e..e@e.@ee.ee...
w...@....e...@e....e@......e..e@@..w
..e.e....@e.e@@e..e@@e..e.e@....e...
..@@e...e.e.ee....e@e.ee@.@e.ee.....
w.ee....@e@e@ee@e.@e.e@ee@e..@@ee@.w
..@e.....@e@e@e@e@.@e@e.e@e.ee.@ee..
..@e...e@e...eee@e@e@e@...e@@.......
w.e......@e.e@@e...e..e..eeee.e....w
....e@e@e.@ee@e...e@..@ee@@e.e@.....