33,36
350
350
1000
..e@e.e@e@e@e......e.e@e@e......e...
w...e.e@ee.e....e..@e..e@...e@.e@e.w
....@@e@e@.@ee@e@...ee.ee..e.e.ee@..
...@ee@.eeee@.e@e@.e@@e@@e.@e@e@e@..
w..e..e.@@@e.....e@@@ee@e@.e@ee..e.w
..e@..@eee@@e.e.e.eee...e@e..@@.....
..e@e.....e@@.@e@e.e@@e...e.@ee@e...
w.@ee......ee.e@.@e.@ee@.e@@e......w
....@e....e@@e..e@@ee..ee@@e........
...e@@e@...e@@...e.e@.e.@ee.e@......
w...e..e.e@.eee..@e@..@.@ee@.ee.@e.w
....@e...@e..@@e......e@e.@e.e@.e@..
..e...@e.@e..e....e......e@@.@e..e..
w.@e..e@.ee.@e@...@e.e@...ee....e@.w
..e....e@@@ee.e..e@e.@e.e..eeee.....
..@.e...ee@e@...@e..e@.e@@e@@@@.e...
w.ee@.e@ee@....ee....e...e.eeeee@..w
..eee@e...e.e.e@..e@e......@e@.e@...
..@@e...e@e.@.e@ee@@e.....ee@.e.e...
w.e....@e...e.@@ee.e@....e@@e.@e.e.w
..@e...e.@e.e.eee@@ee@e.@e@e..e@.@..
..@e.....e.e@.@e@@e.@@e@e@@e..@e@e..
w.e.e@ee.e....e@.e..eee@e.e@e@e.ee.w
..@@e@.@e@........e..@@ee@ee@...@@..
..ee@ee@e@.ee..e.e@..e@..@e@@e.@ee..
w....e@e.ee@@e@@@e....e.eee.e..e...w
......e@.@..e@eee.....e@@e@@e.......
.......e@e..@e.....ee.@e.e@e..e@....
w..................@@ee@e@.....e...w
....e@e........e...e@e@....@ee..e@..
....@e.e@ee@..e@...e..@e@e.e.@e..e..
w.@e@e..ee@e..ee...@@ee..e.....e@e.w
..e....e@@e..e@@e..ee@...@e.....e@..