33,36
340
340
1000
..e..ee@.e@e.@e...ee@e@@e...e@e.....
w.@ee@@ee@e.@e..e@@ee.ee....e@ee...w
...e@e.e@.e.e.e@.e@e@.@e......e@....
...@...e@.@@e..e.e@@@e.e@e...ee@e...
w..e...@e.ee.e...@eee..@.@ee@@@e...w
...@.e@..e.@.@e..e@@...ee@e@ee.@e...
...e.@e.e@.e@.e@e..e.e...e.e@..e@...
w..@ee@e@..@eee@@e..e@e..@e.@e.....w
..e@ee@@e@ee.@eee@....@e....e...e...
..e@..e...e@.@e.@e.e@ee@...e....@e..
w..e@e.....e@e@e@.@ee@e@e.e@..e@e@.w
..eee@....e@@e.@e.ee@e@e@......@e@..
..@@e....e@@e....e@e.e@e..@e...e.e..
w.e........e..@e.@@ee@@e..e.....e..w
..@e........e@e..eee..e...ee@...@...
..e@....e@ee@e.e...@e....e@.e@e@e...
w..e.e@e@e..e@.@....@....@e..e@e...w
...@ee..e@...e@e@e..e..ee....e@@e...
..e@e@...@e............@@e@..@e@e...
w.@e..e@ee@e..e.@e.@ee@e.@ee....e..w
..e@.e@....@e.@ee@.e@e@@e@.@e..e@e..
..ee.@e@e..e@...@e....e..e......e@..
w.@@e@e.e@e....e@@e@....e@....ee...w
..eeee@..e@.e@eee..e...e@....e@@....
....@e....e@.@e@@....e@@ee@..@ee....
w...@e.e..@e@ee@e.e@e.e.@@e.e@.e@e.w
....e.e@....e@@...@@e.e@e...@ee@@e..
....e......e.@e@.eee....e..ee.e.e...
w...@....ee@.e.ee@@e@...@e.@@e@....w
..e@e...e@@e.@..@e@ee@.ee@.ee....e..
..e@ee@ee@e@.e.e..e@eee@...e....e@..
w.@e.....e....e@...e@...@ee@@e..@..w
..............e@e@e@....e.@ee...e...