33,36
360
360
1000
..@e@e...e@e@...e@e...e@@e.@e.@ee...
w.e.@e.e.@e.e..ee.ee...ee@.e.@e.@..w
....e..@e@e...e@@e@@e..@e..@ee..e...
..........@e@e.@e@..@...@e.e@.e.e@..
w...........e@@e....e..e.@ee@e@..e.w
...e@e.e@.@e..e..e@.e@e@....e@e..e..
..ee.@@ee@e...e..@e.e@@@e@e@e.@.e@..
w.@@.ee@....ee@e.ee@@eee......e..e.w
..ee.e......@e.@e@@e.ee@..e.e@..e@..
..@ee@@e..@e....@...e@..e@@e.e..e@..
w.@ee@e.e.e...e.e@e.e@eeee.@e@.e.e.w
..e...@e@@e@ee@@e..@e.@@@ee....@e...
..e...e..ee..@.e...ee.ee@e@@ee......
w.@e.ee.e@@e.e..@ee.@.e..e.ee@.e...w
...@.@@e@e@.e@e@e.@@e.@ee@..@ee@.e..
...e.e...ee...e@e@ee.e@e.@e.e@@ee@..
w..e....e@@...e@.ee@.e@e.e@e@.e@e@.w
...@..e@@eee@e@ee@..e@@e...e@e...e..
...e.e.e...@e.....ee..e...e@@e......
w..ee@ee..e@..e@..@@e...e..ee......w
..e@@ee@@e.ee@ee..e@e...@..@...e....
..@.@ee@ee@ee@e...e@e...e.ee..e@....
w.e.e@e....e@e.....ee@e...@e....ee.w
..@e.e@e@.e@.@e@...@e@e..ee..e.e@@..
..e@...@e.@@ee.e@ee..e@.e@@ee@e@.e..
w..@e....@ee.....e@e@.ee.e@e@e@@ee.w
...e.....e.........@ee@@...@...ee@..
..e.....eeeeee......@e@ee..e........
w.@e...e@@@@@@ee..eee..e@.....@e...w
..@ee....eeee@@@e@@@@e.@e.....e.....
..e.@....@e@.ee@.eee@e@@e..@e.e@....
w.@ee....ee@@e.e@.....ee.e.e...e@e.w
........e@@ee...e.....@ee@e@..e@....