33,36
361
361
1000
..e@e.e@e..e@ee..e@e@e....ee@..e.e..
w.e@e.e@e..e@e@..@e.e@e.e@@ee@e@e@.w
..e.eee....e@@..@e@.e@@e@e......e@..
..@e@@@.e..@ee..ee@.@e@e...e@ee.@e..
w.e..eee@@e@ee@e..e.....ee...e@....w
.......e@ee@@e@........e@@e@e.......
......ee...e@.e@...e@.@e.e..........
w.e@ee@@....e@@e....e.e............w
..@e@@ee....@ee.e@e@....e@e.@e......
....e@@e@e@e.e@.e@ee.....e@@e.......
w....ee...e.ee..@e@@e..ee@.ee....e.w
....e@@e.e@e@@e..e@@e.e@...e@e@e@@..
..e@e@e@..@e@e@e..ee@.e.e..e@ee@ee..
w.e@ee....e.e.e@.....e@e@ee.e@.....w
..e@e.........e@e.....e@..@e.e@e.e..
..@@e....e@e.....e@ee@ee.e@..e@@e@..
w.ee..........e..@ee.e@@.@e..ee.e..w
..e.....e@e..e@..e@@...e@....@..@e..
..@e@eee@.e..e@..e@e...@ee@e.e...@..
w.e@e@@e..@e.@e..@ee..e@ee@@e.e..e.w
.....e@e.e@e..@e.e@@e..@e.e...@e....
...e@@e..e.ee@....e@e..e.....e@@e@..
w...e.e@e@e@.e..e@e@..........eeee.w
.......e.e@e...e@e.ee@..e@ee...e@...
..e....@ee@@..e@.....e..@ee@..e.e...
w.@...e@.@ee..e@...@eeee@@@...@e@..w
..e....e.@e@...ee@eee@@eeee@e@e..e..
........ee@..@e.e@...e@....e.e..e@..
w.e.e@e.@.e..ee.eeeee.e.e.e@e@e.@e.w
..@e....ee@e..@e@e@@@e..@.@e@.@.....
..e@....e@.@e@ee@..e.@e@e.@ee@e@e...
w.e....@e@e.ee@@eee@ee.e@.e.e@e@@e.w
..@e...ee@e.@e.e@@ee@@e@e...@e.e....