33,36
357
357
1000
....e@ee@..ee@ee@@e@e...ee.e@e..e...
w...e@..e.e@e@e.eee@ee.e@@.e@@e.@..w
.....ee@e..e@@e....e@@.e@e.@e..@e...
........@e...e@e@ee@@eee@e.ee..e....
w....e.e@e.......@e@ee@@e.e@@...e..w
...@e@...@e.@e.e@eee@....e@ee@..@...
...e.....e@.e....e@@e..e..e@.e..e@..
w........@e....ee.eee..@e@e@e....e.w
......@e.@e.@e@@@e@@@@ee@e..@e......
...e..e@.e..e@ee@@.eeee..@e......e..
w.e@..@e@.e.....ee....@...@......@.w
..e@e.e.ee@@e.e@e.e.e@ee@ee.e@e..e..
...@e..ee..e@.e@.e@e@.e.@e.ee@......
w..ee..@@...ee.ee@@e@e@.e@.@ee..e..w
..e@@..eee@.@@e@@@e.@e.e@.e@...e@...
....ee@e@.e@e...ee.ee..e..@e........
w.@e..e@..@....e.@e@.e.@e.@e..e@ee.w
..e..@e@..ee..e@e@@e.@e@..e....e@@..
..@..e.ee.@@e.@@eee@.e.e.....e.e@e..
w.e.....@ee..eee.@@ee@......e@e.@e.w
...........e@@e..ee@@e@e..ee.e@ee...
..e@.e.e@e@ee@.e@......@e@@@eee@e@..
w.@e.@.@@e...e..ee@e...e.ee@e@@e@e.w
..@e@e@ee..e@ee..........@e@@.e..e..
..e......@e.ee@ee@@e@e...e.eeee@e@..
w........e.e@@e..ee.e@..e@...@ee...w
...e@e...@ee@e@..........@e@ee@e@e..
..e@e@@e.e@e..e.e...@ee@.e@..e@e@e..
w.@e..e...e@.e@e@e@eeeee@...@ee@...w
..@e@@e.e@e.e@e@...e@@@.eee@e.@e.e..
..e@ee......@........ee..@@ee..e.@..
w.......e@e.e..e.e.e@....e..@ee@ee.w
..............e@e@..e........@ee@...