33,36
356
356
1000
..@e@..@ee@@e..e@e......e@e@.....e..
w.e.e@.e..eee@ee@@.@e......e....e@.w
..e@.e......e@e@ee.e.e...@eee.......
..@e@e.e@..e...e.@...@e..ee@@..e@e..
w..e@.@ee..@ee.@ee..e@@e..e@e..e@@.w
....e.e....e@@e@@e..ee@e..e@e...ee..
....e@e....ee@@e....@.@eeee.....e@..
w....@e@..e@@e@@e.@ee@ee@@@e.......w
..e..e@e.ee@@ee...ee@..e@e@e..ee....
..@e@e..e@@ee.e@eee@e..e@e@.e@@@ee..
w...e..e@e.@@e@@e@@e...@e.e@.ee.e@.w
...e@.e@e@.ee.ee@.@e@..e@@eee....e..
..@e@ee@e@.@ee@...e.e....e@@@e@e@@..
w.e@.....eee@e@.........e..ee...ee.w
...@ee@e.e@@..e....@e@e@@...........
..eee....e@e..e@ee@e...ee@e..ee@....
w.@e@..ee...eee@e@......@.@ee@.e@..w
..e...e@@e..@@@.@.ee...@ee@@e..@e...
........@e..eee.e@@@e@ee..e....@e...
w.e.e@..ee@e.....ee...e@......ee...w
..@e.ee.......e@e.@...........@@e...
..@e..@e.ee.@e..@eee.e@ee@e...e@e...
w.e..e@.e@@.e.@e@e@@.......e...@e..w
...@e.e.e@ee@ee.e@.ee.@eee@@e..e....
..eeee..@.e........e@.e@@ee..e@e....
w.@e@@eee.@.e@e.....e.@e@e@e@e@....w
..e..e@@e.e..ee@e@ee@....e@.e.e.....
..e..ee@e...e@.e@@e.....e.e.........
w.@ee@@e.ee...e@@e......@@e@e@.....w
....e@@e@@@@e@e.ee......ee@..e.e@e..
.....ee@eeee@...e@...@e.@..e@.@e@...
w..ee@...@e@.e..e@e..ee.e@e@e.e.e..w
..e@e@e.e@e..@e.....e@@e....@e@.....