33,36
364
364
1000
..e..e..@e@e.e@e.e@e....e@e@e.......
w.@.e@..ee....e@.e.e.....@e@ee@ee..w
..e.e....@e@e@e.e@.@e..@ee...@@e@...
...e@.e..ee@e.....e@e..e.e@@eeeee@..
w....e@ee@e@e.@e..e@@@e...ee..e@@e.w
..ee@@...e@e..e....eee@..@e...@.ee..
..@@ee...e@@...@e...@e...e.e..ee@@..
w.e..e....ee@eee@..e@e@e..e@.e...e.w
...e.@...@e@.@@ee@eee@@e.....@e.e@..
..e@ee...e.@ee@e..e@@@e....e@e.e@e..
w.ee@......e.@.@e.@eee@..e..e@.@e..w
..@@ee@e@e.eee.e@.eeee@ee@@e....@...
..e@e@.e..e@@ee@..@@@.@e..e@e...e...
w..ee..@.@e@e..ee.eee@e...e.@e@e...w
..e@@e.e.ee@e.e@@e...ee@.e@.e@......
...e@e.e@..@e.@.e....@@e@e@e@e.e....
w.......e.ee..e.@..e@e.e@.ee@@e@@e.w
...ee@e..e@..e@.e....@e.e.@eee..e...
...@e@...e@e.@e......e..........e@..
w....e....e@...e....e@eee@e...@e.e.w
..........e@eee@....e@@@e.....e@....
...e@.e....e@@e@.ee..ee@e@..........
w.e.e.@e..e@@e.ee@@.ee.e.ee.e.@e...w
..@eee@..e@.e@...@e.@@.@..@e@.e.....
...e@.ee.@e...e@.e..ee@e....e@e@.e..
w.e@ee.@e...e.@e.e@..e@@@e@e@..ee@.w
..@e@@e@ee..@e@e..e.e.eeeee...e@@...
...e@e.@e@..ee@e..@e@e..e@@...@.e...
w......e@@e.@......e@@e.@ee.eeeeee.w
.......e@e@ee....e.@e@e....e@@e@@@..
.....@ee...@e....@...e@ee..e@.eeee..
w...eee@@e.e@.e.ee..ee@@@...e.@@e..w
...e@@e@e.....@e@@ee@.eee.....e@e...