33,36
353
353
1000
..@e...e@ee@e...........e@@e....e@..
w.e..e.@@e.e@e@..@eee@e.eeee.....e.w
.....@@ee....eee@ee@.e.e@@e@e@e.....
...@eee.....e@e@.@e@e@@e.e....e.....
w..ee@..ee@.@e.....e@.e.....e@@e@e.w
........@@ee@@e.......@.e@...ee@e...
..e.....e...e.....eee.e..e...e@.@e..
w.@e....e@e.....e@@@@e.e..e@e@e....w
....@e@.@e...@e..eeee@.@e....e@.....
....e.ee@.e@.e....@e..e@@e...ee@e@..
w..e.e@@e@@eee.eee....@e...e.@e.@e.w
...@.....eee@@.@@@eee@..e..@e@......
..ee...@e...ee@eee@@.e.e@..e.e.e....
w.@....ee@.e@@eee.ee@e@e@ee@.@e@ee.w
..e..e@@ee@e..@@@e@.@e@e......e@@@..
..e...ee@.e...eee@@ee@..e@e@@e.eee..
w.@e@e....@e..e@e@e@....e@.ee@.....w
..@e@e...@e...e@....e@e..e...@e.....
..e..e@e.ee@...e.....@ee@e...e@.e@..
w.....@e..@ee.@e.@e@.e.e.e@..@e..e.w
......e@.e@e@.e..e.e...@..e.e@e.e@..
......@e.@e@e@e....ee..e..ee@.@@e...
w......e@e..e..e..e@@e@..e@@eeee@..w
...ee..e....@e.@e..@e@e@e..e@@e..e..
..e@@@e@..e..e.....e.e.....e@e..e@..
w...ee@...@.e@ee@..e@@ee.e.e@e..e..w
......@e..ee@e@.e@e.e@@@e@e@e@..@...
.....@e...e@@e.ee@@..eee@e@e.e..e...
w...@e@.....e..@@ee@e.@@@ee@.@@e.e.w
....e..........e......eeee@@eee@e@..
...e@e@...ee..e@@eee.e@@e@.e.e..e@..
w.e..@e..e@@e.e@e.@@eee@e....@..ee.w
..@e.e@..e@e..e@e.e@e@@ee@e..e.e@...