33,36
367
367
1000
.........e.....@e..e........e@e@....
w...e@e@.@e..@ee...@e...e@e@.eee...w
.....e.ee@e..e@e@ee@e.@eee.e@.@ee...
...ee@e@......e..@e@e.e.@e.@ee@@@e..
w..@e.@e..e..e@.e@.@e@e.eee..@eee@.w
..e@e.e@e@@e....@eee@eee@@@.@e..ee..
..e@e@@e.e.@.....e@..@@@@ee.e@.e@@..
w..@eee@@e.e@...e@ee.eeee.......@e.w
...e..@ee.eee@ee@.@@e.@..e@e...ee...
..e..e@ee@@@e@ee@.e..ee.e@@ee..@e...
w.@eee@e@eee@e@.e...e@..@eee@......w
....@@ee@...e..e@.e@e@e@...@.e@e@...
...ee...e..e@..e@e@..e@e..ee....e...
w.e@..e@e..e...e@@eee@..e@@........w
..e@e......@eee.e@.@e...eee.e.e.....
..@@ee@e.ee@@@@e@e...e@e@@ee@.@ee...
w.eee@..e@@eeee@..e@e.e@..e@e.e@@..w
..@ee@@e.@ee..@eee@@ee@@e..e@..@ee..
...e.ee.@ee@e..e@e.e.@.ee@e....ee@..
w..@e.e.ee@e.e.@@e.@.e.ee@e@e...@e.w
...@e.@e.e@@.@.ee..e@e.@ee...e@ee...
..ee@.e...ee.e........e@e.e@e..e....
w.@...@e@e...e.e@.........e...e@e..w
..e.ee@@e@..e@..e.e@e..e.e@e..e@@e..
..@e@.e@e...e@e@e@e@...@e@e...@e....
w....e@@e@..@@e.e@ee..e..e@....@e..w
...e..ee.e..ee@..@e..e@e@e..........
...@ee@e....e...eee....@e...........
w....e@@e...@...@e@..@e....e.e@....w
..e@e.e@....ee..@e@eee@.e@e@.@e.....
.....e.ee@@ee@.ee@..@.e@.....@e@@e..
w....@e.@eee@e.@e..ee..e.....eeee..w
............e@.e@.e@e@e.......@e....