33,36
357
357
1000
......@e@.@e.ee@..@e....e.e.e@......
w.e.e@e.e.e@.@ee..e...ee@.@eee.....w
..@eee..e.@ee@e@....ee@e@..@@@......
....@@e.@e@e.@e..e.e@@eee..eeee.e...
w...ee@.e...@e...@e.e@@@e.ee@@@e@..w
.....@..@e..e...e@@e.ee@.e@@eee@....
.....e@ee@e.e....ee@e@.e.e@e@e...e..
w.e......e@e@@e...@.@e....@ee@@ee@.w
..@...e..@e@.e..e.e.@e...@e.@eee....
..ee..@..e...e@e@e..e@.e@e...e.@e@..
w.@@eeee@e.e@.e@.@e@....e....@ee.e.w
..e.e@@e@...e...ee@e....@e@ee.ee....
..@..e..e.e@ee@e@........e@@@e@@e...
w.e.e@...@ee@...e.....e...eee.e@e..w
..eeee@..ee....e@@e..e@@e..@@.e@e...
..@@@.ee.e@...e@.e...e@e.@eeee@@e...
w.eeee@@ee..@e@..@e@ee@e@e..e@.e...w
...e..e@e@.@e@@ee@e..e..e@e@@e.e@e..
...@@e@e...e..e@@@e.e@..@e.e@ee@@e..
w..eee@e..e.....ee......e@..e.@ee..w
....@e@.e.@.............e@e.@ee@@e..
......e@@eee@...........e@e.e@.e@e..
w.e....e..e.e....ee@....e@e.@ee.@e.w
..@e..e@ee@@e...e@ee...e@@e...@@e...
..e@e.@..e.e...e@.@e@@e@.e....ee....
w.e@@@e..@.@e.ee@ee.ee..e@@e....@e.w
...eee@..e....@eee........e@....e@..
..@e@@ee@@......@@ee.eeeee@@e.......
w.e.....eee@....e..@.@@@@@ee.....e.w
...e@...e@.e......ee.eeeee@ee...e@..
..e.e..e@@e......e@e@e@.@e.@@e..e@..
w.@ee.e@@e.....e@@ee@e@e@@ee.....e.w
....@ee@e.......e@e.e@..e@e.....e@..