33,36
354
354
1000
..e....e.e@e@e.......e@...e@@e......
w.@e..e@.e@ee@....e...e....eee@e...w
....ee@@ee@ee@.e.e@...@e...@e@e@ee..
....@..e.e@e.ee@.e@@e@e@...e...e@@..
w.@ee.e..e@@.e....ee@...e@e...ee@e.w
..e.@e@...ee@@ee..@e.@e@e.@e..@e@e..
.....ee..ee.e@@@ee.@ee@e@....ee@@e..
w...e@@ee@@..eee@@e.........e@..e..w
..@ee@e.e@e....e@@eee.....e...@e@...
..e.e@e@@e@....eee@@@e...e@.e.e.e...
w.@e@@ee.e@...e@.@.e@@..e@ee@@e.@..w
....@e...ee@.....e..ee....@e@e..e...
....e...e@ee.e.e@e...ee.......@e....
w......e@@e@e@@e@@ee@@@e......e..e.w
...e@..e@e....eeee..ee...e....eee@..
....e..@@e..e@e@e@e....e@@ee.e@@....
w......ee.e....e@@e.....e.@@ee@e...w
.....@e.e.@e.....ee....e..e..e@e....
..@e.e.e@....e@e.@@@e@e@....e@e.....
w.e@@e.e@..e...e@eee@..@ee.e@@ee@e.w
....e...e..@e.e....@e..e@@.@.eeee@..
..e....@e@e@..@e..e..e@e@e@e.e@@e@..
w.@..@eee@ee@e@.ee@e@ee@....ee@e.e.w
..e@.ee@.e@@e.ee@@ee..e@e..e@@e@....
...ee@@e.@ee@....e@@e.....e@.e......
w.e@@e.....e.....e@e.......e.e...e.w
..@e..e...e@e.............e@.@e@e@..
....ee@..e@e@e@e.e........@e...e@...
w..e@..e@e@e..e@.@e...e@ee@e....ee.w
....@e..e@@e..e..e@.e.e@@e@@e..e@@..
...ee.e@eee@..@e@ee@@e.e@.e@e....e..
w..@e..@e@.@ee@ee@@e@@e.e.e..e@ee@.w
....@e.e@e.e@.e@e@e.e.....@e.....e..