33,36
362
362
1000
.....e@e.e@e.e@@e.....e.e@ee.e..e@..
w......@e..@..ee......@.e@@@e@..@e.w
......e@@..e..@@e@....e.@ee@e.e@e...
..ee@..ee.e@..e..e....@ee.@e..e@e...
w.@ee...eee......e@e.e@e@ee@..e@...w
..e@.eee@@@.e...e@@e.e@..@.e@e.e....
..eee@@..eee@e..e@e...eeee@....@....
w.@@e@e.e@e@.@e.e@.e...@@eee@e.e@..w
..eee@ee..e@e@e.@ee@e@eee@@e@e..e...
..e@.e@@@ee@ee@e@e@ee.e...e.ee...e..
w.e@ee@ee.eee..@e@e@@e@....e@@...@.w
...e@...e@@@@...e@e.e@.......e...e..
..@e@....eeee......e@@ee@e....e@e...
w.eee.e@e@@.@e@e...@@e.@@ee@e......w
..@@@.@ee.e.ee@e..@ee..ee@.....ee...
..eee..@@e....e@..e....e@...eee@@e..
w......e@e....@@e..e...@e..e@@e.e@.w
..@e..e......@ee..e@@eeeee@.e@......
..ee..@......e.....eee@@@@e.@ee..e..
w.e@@ee....e...@ee.@e@@ee.@e..@ee@.w
....e.e@e..@e..e@@ee@.e..e@@...@e@..
......e@ee...e@.e..ee.@e.eee...e.e..
w.....e@e@.e@@ee@.e@@e.ee@.e...e@e.w
....ee@.@e.@e@@e@e.e@e@@e@e@.@e@e...
....@........ee..e@@e.e..ee@.e..@e..
w.e@e..e@e...@e@..e...e@...e.......w
..@.ee@@e.e@@eee.......e@e......e...
..ee@.ee...ee@@.@ee@.e@.......e.@e..
w.@e@e@@e...@@e.e.@e.ee......e@e.@.w
..eee.e@....eeee.e@.e@.e@e.ee@e@.e..
..e@@.ee.....e@@e.e.@e....e@e@e.....
w...e.@...e...ee@....e....@@e@ee@..w
...e@.e..e@..e@@e...e@....ee....e...