33,36
351
351
1000
.......@ee...e@...e....e.e@e...e....
w.e...ee@@e.@ee..e@ee@e@...@e..@...w
..@e.e@e@@e.e.e@e@..e@...eee@..e....
........ee@....e@....ee@e@@e@e.@e...
w.e@...@e@.....e@.......@.e......e.w
...ee..e..e..ee.e....e@ee..@e....@..
..@e@..e..@.e@@e.........@ee@....e..
w.ee@e@@e.e......e..e@e..e.e....@e.w
..@e..e@e......e.@e@e.@e.@e@e@e.ee..
.......@e.e@e..@e@e.ee@e.e@@e...e@..
w.e....e@e@..eee.@ee@.@e.@eee..e@e.w
..@e@..@e@.e@@@e.e..e@e..e@.@.......
....e...e..@eeee@........@e.e.@ee...
w..@ee@e@....e@@e@...e@e.e@...ee@..w
...ee@.e@e@e@@@e.ee@e@.e..e...e@@e..
....e@e@....eee@e@@e@.e@ee@e@e.ee...
w.e.@@ee@....@@e.@e..e@e@@.@@ee@...w
..@.ee@.e@.e@e...ee..@@e@e.ee.e.....
..e..ee@.e.e@@..ee@e.ee.@e...e@e@e..
w.@e.@ee.@e@ee.e@@e...@@e@...e@e...w
...e@@e@e@.e@.e.e@e@..ee.....e@e....
...@ee.e@e...e@ee@@e...@e@.e@@......
w.e....@.......@ee@.....ee.@ee@....w
..@..e@e.e@...e@@ee...e@@e@...e.....
..e....ee.ee..@e..e@ee.e..e.........
w.e...e@@..@e...e@@e@@.....eee@e@e.w
..@e@.e@e......e.e@e@e...ee@@@e.....
....e.@e.......@eee....e.@e.e.......
w.@e@...@e.e@e@e@@@e...@e...@e.e...w
..e.e@e.e...e@e..eee@.e....e.e@@....
..@eee@eee@ee...ee@eee@e...@e.eee@..
w.e.@@e@@@e.@e@e@@..ee@@e.e@e@e..e.w
..@eeee@e...e@e..e.e@.ee@..e@.......