33,36
354
354
1000
...ee@.@ee..@e.@ee@e...e.e@@e.e.e@..
w.e@@e.e.@e.ee.e@e@e..e@..ee.e@.@e.w
...e...e@@e.@@ee@e...e@@ee@...@ee...
...@e.e.ee..ee@e@e.ee@ee......e.@e..
w.e@.e@e.@....e@e@e@..@e@..@e@...e.w
...ee@.e.e@...e@e..@eee.e..e@e...@..
..e@...@eee.....@..ee@.e@@e.e@...e..
w.ee.....@e..ee@e.......@e....e....w
..@@@e@e..e.e@e@@e@.....ee@e@e@@e...
..eee..@..@e..eee.ee......e@...e....
w..e@.ee@.e@e@@ee@.@e@e.e@@.e......w
...e@e@@e.e..eeeee@e@....eee@ee.e...
...@e@@e.e@e..@@@@e..e...@.ee@@e@...
w.e@e.eee@@e..eeee@e.@...ee@@eee@e.w
.....e.@e@e..e@..e@@.ee@e@.e@@e.e...
..e.e@.@e.......e.ee.@e@@e..e@@e@...
w.@.e..e.e@e@..e@...ee@ee@@eee@e@e.w
..e.@...e@@ee.e@@e@e@@e..eee@@e@....
...@e...e@e.e@e@e@e@@e@..@e@e.......
w..e...e..@e..@e.@e.e....e@.@...ee.w
......e@e@e@....eeee@.e.e@e@e.e@@@..
.......e@.......@e@e@e@.....@.eeee..
w....eee@e@e..eeee...@......e.@e...w
...@e@@e@@e.ee@@e@...e@e.....e@eee..
...e....e@..@@e@e@..........e@@e@@..
w..e.....e..e@.e@ee......eee@.e..e.w
...@e.e......e.@e.@.....e@@.........
.....e@..e@..e..e@e@e.....e.........
w.@e.e@e..eee@..........e.....e....w
..e..@...e@@e..e.e@e@@e.@....e@e.e..
.....e@e..@e...@.e@eee..e@e..@e@e@..
w.e@eee@..e....e.e@e@ee@e.....e@@e.w
...e@@e.........e@e..@e.@e.....ee...