33,36
354
354
1000
..@e@.....e..e..e.e@e..e@e.@e.e@@e..
w.e.e@.e@.@@e@.e@@e@e..e@e.e.e@ee..w
..@e.e@.eeee@....e....ee@e.@e@..ee..
..e@@ee.e@e@e@e@....e.@e@@.e....@@..
w...e.@e@@e@e@.ee..e@.e@eee.e@e@ee.w
...ee@e..e@..ee@@...e@e@e.@ee.......
...@e.e.......e@e.@e@.e@....@.ee....
w.e@ee@......e.@e@e....e...@ee@@e..w
.....e@e.....@.ee..ee.....ee@e@e@...
....e@......ee..@e@@@.e@.e@@..ee@e..
w.....e@.@ee@...e.eee.@e.e@e@@e....w
......@e@ee@.e....e.e@e@...eee.@e...
...@ee@ee.e@e@e@e.@..e.....@@..e@e..
w..e@@ee@.@e..e@e.e.e......ee.@e@@.w
...@e@e@.e..e.@e@...@e.@e@e@@ee.ee..
..eee@...@e.@e@e...e@e.e.ee@@e.e@@..
w.@..e....@e.e@e.ee...e...@eeee@.e.w
..e...@e.e@..e@e@@@e@.@@e..e@@e.....
..@e..e...eeee@eee.@e.ee....e@.e....
w.@e......e@@e..@e@e..e@....@e.@e..w
..e.......e.....e@.e.ee......@e..e..
.....e@e@.@e.......@e@@e..e.e.@ee@..
w..e@e..ee..e@...e.e.e....@e@@ee...w
..e@e.e@e@e@ee..e@...@ee@e.e@e.@.e..
..@e..e@e@e@....@e..e@e...e@..ee.@..
w.....e@@..e..e..@e@e.....@...@e.e.w
...e..@ee..@ee@..eee@@e...e...@e.e..
..e@e....e......e@@@@e@e.....@e..@..
w.@@e@...@e.....e@eee..@.....e...e.w
..ee.e@e@@e.....e@.....e.e@e.e@.....
........ee@...e@eee@e@e..e@.eee..e..
w...e@e@@e...e@..@.....e.ee.@@.e@@.w
....@e.e.@e@ee@e.e@e..e@e@@eee..ee..