33,36
371
371
1000
.....e.e@ee@e..e.@e@e.e@.e@...ee....
w....@.e@ee@eee@eee@...e.@e..e@@...w
.....e@....ee@e@@eee...ee@e...ee....
......e.eee@.e.e@@@e@e.@e...e@@@e...
w.@eee@e@@e@e@..ee@e...ee@e..eee@e.w
..ee@@e@@e.e.......@e@e@.e.ee@e.e@..
....@e..e.....e@....@ee@e@e@@e.e@e..
w..ee..e...@e.@e..e@ee@@e..@e.@e...w
...@e..@e..ee......e@..e.e.e..e@....
.........eee@eeee.e@@ee@e@.e@ee@ee..
w.@e...e@@@e.@@@@ee@ee@....e@eee@@.w
..e..e@eee.e@eee@e@e.@@eee@e.e@@ee..
..@e.@e.@.@e.ee@.....eee@..e.@e.@...
w.......e.e.e@.e.....@.@e.e@e@..e..w
...ee@..ee@e...@e....e@ee.e..ee@e@..
..e@.e@e@@e@@e@@e.e@..@e@e@....e@e..
w.ee@eee@e.ee.ee...e@.e....e@e.....w
..@@@e@....@.e...ee.e.eee...e.......
..eee@e.@e.e.@e@.@@eee@@@e..@ee@e...
w.e.e@@.e@.@e..e.ee@@@eee@.e@@e@...w
..@eeee.e@e...e...e@e..@e...e@ee....
....@e..e@e@ee@@e.....e@e@e.@e@@e...
w....e..@e...e@e@e@e..ee.....e.....w
..@ee@.e@@e.e@eeee@e..@@e...e@......
..e.....e.@e@e@@@@ee@.eee....e@e....
w.@.......e....ee..@e.e@@e..e@e@...w
..e......@e.e.e....@e..e@e..@e......
.........ee@@e@e.@ee..e@@e.e@@e.....
w.......e@.e.e@@ee.....ee...e.@e...w
..e........@e.e@ee..@e.@eee...e.....
..@....e@e@e..e@.@.ee..e@@@.e.@.....
w.e....@e..e.e.e@e.@e.e@eeee@.ee.e.w
...........@e@....e@e.@e..@e...@e@..