33,36
354
354
1000
.......e@ee@e@ee@@e@e@ee......e@e...
w.e@e..e@..@e@@eee.e.e@@e..e@e@..e.w
..@.....e.@e.ee@......e.........e@..
..e.....e.e...........@ee@......e@..
w.@.....@e.....e@e@ee@e..e....@e.e.w
..e..e.....e..@e.@@e.e@..ee@..e.e@..
....e@@ee..@e.ee.ee..e@e@@ee..@.@e..
w...e@e.@e@@e.@@ee...@e.e.ee@.e@e..w
...e@..e@eee..e.e@..e@ee..@ee.......
..e@e@ee@e@@e@e.e@.e@e@@@e@ee..e....
w.@.e@ee@@ee@e@..e.e@e.ee...@e@@...w
..e....@e..@..e@e@...@e@e.ee@.ee....
...e@.@e.@ee...e@ee@e@..@e@@e.......
w...e@e@@ee...e@e@e@eee.........e..w
..ee....ee@..e@.e@.e@e@..@ee@ee.@...
..@@e.e.e@e@e....e...e@e.ee@.e@.e...
w.e@ee@e..ee@e.e..........@.....ee.w
....@@e@@e@..@.@e.e@e.....e.e@.e@@..
....e.e.e@...ee@e.......e@e..e...e..
w.eee.@.ee.ee@@eee.@e.@e..@........w
..@@@@ee@@e@@ee@@@.e..e...e..e@.....
..eeee.@e.e@.e@@ee...e@...e@e.eeee..
w..@@.e@@e.ee..e@@e@e@e@eee.e@e@@@.w
..eee.@e@..@@e.e@@ee@...@@@..e@@ee..
..@e.e@.e.@e....eee@.ee.eee..e@e....
w.@e.ee..@e.......e@e@@......ee@...w
..e.e@.e.e..e@e...@ee@ee..e@e@@e.e..
...e@..@.@e.e@.....@..e@......e.e@..
w...@e.e.e@..e..e.ee...e..e@ee@.e@.w
....ee@e.e@.....@e@@e..@ee@..e@e.e..
.....@e...e.e.....e@eee@@@@e@e.e....
w.e..e@...@e@...e@ee@@eeeee..@e@...w
..@e......................e@e@e.....