33,36
363
363
1000
...ee@ee@eeee@.@eee@e@ee@e@..e@e....
w..@e@e..e@@.eeee@.e.e@.e.ee.......w
..@eeee...@e.e@ee@e..e@e.e@@....@e..
..e@@@@e@ee...e@@e@e.@..e@ee....e...
w.e@ee..e.....e@@e.@ee.e@e....ee.e.w
..e@@e.e@.e.e@eee@.e@@e@@e...e@@e@..
...e..ee@e@e@.....e@e@e.e@...e@e@...
w...ee@....@ee@.e.@..@e..@ee..@e@..w
...e@@e......@e.@ee..e..ee@@e@e.e...
...@e@eee..e@@e.e@..e..e@@.e@.@ee@..
w.....e@@e..ee@.@e..@..e@e..@e@e.e.w
..@e..e@@e.....e@ee.e@..e...e.e@....
..e....ee.e@.@eee@@.ee.e@ee.e.e@e...
w...e@e@...e@ee@@ee.@...e@@e@......w
...e.@e.e@e...@.e...e@ee..e...e.e...
...@ee.......@e@@...@e@@e@@ee.@e@...
w.e@e...eee@ee.ee...e.@e.e@e@.@e.e.w
...e@...@@e.....ee..e.e@...ee@e@e@..
....e...e.@...e@@@..@e....e@@@e.....
w...@e....e...@eee.e.@ee.ee@ee.....w
....@e.e.......@...@e..@e@...e@..e..
....ee@@e..@ee.e..e@e.e@e.e..@e.e@..
w.e@e.e....ee@@e..e@e.@e.e@..e@@e@.w
...e@e...e@.@.e....e..@e.e@e@..e.e..
..e@e@.ee.e.e.@ee@e@e@e...@ee.ee....
w.@ee@.@@...@e@.@ee@e@e...e..e@@e..w
.....eeeee@ee.ee@.............e@e@..
......@..@e..e@.e.e@e....ee@ee@e.e..
w.....e..e@.ee@e..@e..e@e@.e.@...@.w
.....ee@.@e.@e@..e@ee......@ee..@e..
....e@.e...e@@eeee..@.ee@ee.@...e...
w.......e...e@e@@@e@e.@@e@@.e......w
.......e@....e@eee....e...e...e@e...