33,36
350
350
1000
..e@@e....ee......e...e@e@....e.....
w..ee...e@@@e.....@e@e@@ee..e@@@e..w
...e.e@eeee@..e@@ee@@e.e....@eee....
...@e...@e@eee.ee@@ee...e@...@@e.e..
w.e@ee.e@e@e@@e...@e@.e@@e...e.@e@.w
..@ee@.@e.e@.@e@.@e...@ee@..@e@e....
..@e..e...e@.e.eee.e.e@@e.@ee.e..e..
w.e...@e..ee...@@e.@e.e@e@e.@e@ee@.w
..........@e...e.e..e..e.e...e@@@e..
..........@e.e..e@..@e@@e@....ee....
w.....@e..e@e@e......@e@e@e@e..ee..w
......e@..@e@e@.@ee@e..e.e....e@@...
....@ee.....@e@.e...e..@.e@e..e@e...
w...e@@...e.e.e@e@e@@e@e.e@eee.e@..w
...ee@e...@@e@eee@ee@@.@e...@@e.....
...@e.e.e@ee@...ee@eee.e@...e.e@e...
w...ee@e.....e@e@@e@@e.@e...e..e...w
....@@e@e....@.e@e.@e....ee@@e.@....
....e...@@ee.e.....ee....@ee@e.e....
w...@...ee.@e@.....e@......e..e....w
...@ee@....@e.....@e.......@.e@..e..
...e..e@e..e......e...e@.e@e.e@ee@..
w..e....ee.@ee.....e...e.@e@...@e@.w
..e@...e@@ee@@.....@e@e.ee.ee@e..e..
..e@e.e@@e.e.e@.@e.e.e@.@@.@.@e..e..
w.e@e@@ee.e@.ee.ee.@e@e.eeee.e...@.w
..@e.e......e@..@@@e@e@eee@e@e@.ee..
..@e.e.....e@@e.eeee@ee@@ee@..ee@e..
w.e@.@.e...@.e....@e@e.@e.@e...e@@.w
...@ee@@.e.ee@ee@ee@@e.e@.e@.@eeee..
...e..ee.@...e@@..e.e..@e.@e.e@@e...
w.....e.ee..@e.e..@e.....@eee..e@..w
......@e@.e@e..@e........ee@@e......