33,36
354
354
1000
........eee@ee@e.e....ee@e..........
w.e....e@@e..@e.e@@e..@.........e..w
..@e..ee@e..e@eee@e...e.e......e@...
..e@.e@.e@..e@e@e@...e@.@e@e..e.@e..
w.....eee@....e@@ee@.@ee@@ee@e@.e..w
....ee@@ee.....e...e....e@.e@ee@ee..
...e@@e@e@.e.....ee....e@e.ee@@e@@..
w...@ee....@e...e@@...e@e.e@@e@e.e.w
....ee@e..e....e@@e...@e@e.e@ee@....
...e.@@e..@ee@...ee@e@ee@@eee.@e@e..
w.e@.ee@.e@eee....@@e@e.e.@@@ee....w
..e....e..e@@e@e@eeeee@..eee....e...
..@...e@..e@eeee@e..@@e@.@e@....@...
w.e......e@e@@@@e...e.ee..e@....e..w
.........@...eee@..eee@@.e@e.e...e..
......e..e....@e..e@@e@e.e@..@e@e@..
w....e@......@e..e..@e...ee.e@...e.w
..e...e..e@e.e...@e.e..ee@...e.@e@..
..@.ee@..@.........@e..@@e.....e@...
w.ee@@@eee@ee......e@..e....e...e@.w
..@e.ee@@@.@@e....e@@e@e@e..@e...e..
..e@.@e.eeee.e@e....e@.....ee@e@ee..
w...e.e@@@@....e...e....eee@..e@e@.w
...e@..eeee...e@..e@..e.@@@..e@@e@..
...eeeee......e@e..e..@eeee.e@@e.e..
w.e@@@@@ee....@ee@e@........e.e@...w
..e@eee.e@...e@e.e.....e@e..@eee....
.......ee@ee.....@@eee..@e..e@@@e...
w...ee.@e@.@@e.e@eee@@e.e@e.e@e@e@.w
....@@e.@e.ee.......e@@e@e@e@@ee.e..
....e@@e....e....e@e@e@.@e@e@e...@..
w.e.ee.e@eee@e...@e@@ee.ee@e.....e.w
..@e@..@ee@@e.......e@@e@@e.....e@..