33,36
349
349
1000
..ee@ee@e.@e.ee@....e@@e.....e@@e...
w.@...ee@.e@.@ee@e@e@ee....e@eee...w
..e...@...@.e@.ee.......ee@e@e..e...
...e@ee...e..ee@......e.@@ee@ee.@...
w.@e........e@e.......@ee@@e@e@.e..w
..e.e......e@e@e@e...e@e.ee.e@e.....
...e@..e@ee@@e.@e@...@ee....e@@.....
w..@e..@ee@.e@e@e..e..e@....@ee@e..w
........e...e@e@...@.@e@e......e@e..
..e@....@...e@ee...e.ee@.e.....@e@..
w..e..e.e....@e@.e..e@@ee@.......e.w
...e..@.e@e..e@.e@e@@@ee@.......e@..
..e@eee.@e..e@e..e@eee.@ee...e@e.e..
w.@ee@@e@e@..e@.e@@ee@.e@@e.e@e@.@.w
..@e....e.e.....@ee...@e@@e....e.e..
..e.e..e@.@........e@@e@ee@..e@@e...
w.@e@.e@e.e....@e.e.ee.e@.e...e....w
..e...e@@e.e@e.e..@ee@...e@..e@.....
..@....eee...e.@e@@e.e...e@e...ee@..
w.e....e@@ee.@e..ee.e@e..e....e@ee.w
........ee.@.e@e@e@e@e@.e@e@ee@.e@..
...e...e@@.e...@@e..e..e@e..e@@e.e..
w.e@.@e@.e.....ee...@ee@@e....e@e@.w
..@..e..ee.e@e..@e....@@e@.....eee..
..e.....@@e.e@.....e@eee......e@@@..
w..e@..@e.@..e@e.e.e@..@e@ee@...ee.w
...ee@ee@.e@...@e@..e.@e..@ee.e@....
..e@.e@@e.@e...e@....eee@e.@e.@e....
w..@ee@@e...e@e.e...e@@e.e@e@.e@@e.w
...e@.eee@e.....@e@e@@e@e@......e...
...ee@e.@.@ee.eeee@e@ee@@@e....e@e..
w.e@e@..e@..@e@@.@.@@e.eee....e@...w
.....e...e..e..e.e.ee@..e@....e@e...