33,36
372
372
1000
...e.e@e..@e......e@e.@e@ee.....e@..
w.e@ee@e..e@..e...e@e@ee@e@....eee.w
..e@@e@e......@eee@@ee..e.....e@@...
..@e@e@e..@e...e@..e.@e...@e..@ee...
w...ee@.eeee..e@..e..@e...e@e......w
......ee@@e@...ee.@e.e@ee...@.......
......@e.@e@@e@@@e....e@@e..e@eee...
w........e.ee.ee@eeee.e@ee@e@ee@@e.w
.....e.e@e.@e@e..@@@@..@ee@ee@@e@...
.....@e....e..@e.eeee.ee.@ee@e@ee...
w........e@.e@e@ee..ee@ee@e@.e.....w
......e@e.eee@.e@@e@@@@ee@e..@e@e...
...e.......@.e...e.eeee.@ee@e@ee....
w..@..eee..e.@...e@e..e..@e@..e@e..w
..eee.@@@e@e.ee..ee@..@e@@ee....@e..
..@.@.eee...e.@e@@@e@.eeee@@eee.....
w.eee..e@..e@@eeee..e.@@e@.e@@@e...w
..e@@ee@....@ee@.....eee@e.e@e......
..@e@e.e@...ee@@e..e.@e@.@e@.@e..e..
w...@e..e...@.ee@.e@@e.e.....e@.e@.w
....e@@e@...e@ee@e.@e.e@e..e@e@ee...
..e.eee...eee@e@@e.e..@.....e@@e@...
w.@e@@.e@e@@e...e.ee..e..@e...ee@e.w
..ee@e..e.e@ee@e.e@@.....e....e.e@..
..@@ee..e...@e@e..@e.e.....e@e@e....
w.e..@ee@e..e@@e@.e..@e.....eee@...w
..@e.e@@.e..@@e.e.......e@ee@@@e@e..
....e@.ee@..eee...e@e..e@e...e@e@e..
w.............@e.e@.e@@ee@..e.e..e.w
..e@e...e.......ee...eee@.e@@e..e@..
..@e....@e.@e...@@e@e..@e..ee@e@@e..
w..e@......e.e..e.e.ee@ee..@e..eee.w
....e.....e@e@...e@e@.e@@e......e@..