33,36
369
369
1000
...e@..e@..e...eee@@ee.e@ee@e@......
w...e...e.e@@ee@@eeee@e@@e...e.e...w
..e@e...@ee@e.....ee.e@.e@e....@e...
..ee....ee.@e..e..@@e@e...@@eeee....
w.@@.ee.@@.e..e@..e@e.@ee@eee@@@e..w
..eee@@eee@ee.@e..eee......@@ee.....
....@e....e@@e@e.e@@@e.e@e.e@e@@e...
w.........e@ee@..e@e.e@e.eee@e.ee..w
..@e.@e.......e..e@e@e@@.@@ee@e@@...
..e..e...e.........e@eee.e.e@e@.e@..
w...e@..e@ee....e@e...........e@.e.w
.....e..@e@@@e...........@e....e.e..
..........@eee@e..e.e@...e....e@e@..
w.e@e.ee..e..e@@e.@..e...e....@e@..w
..ee@e@@@ee..@e.eee.e@...@.e@eee@e..
..@@e.@ee.@.e.ee@@e......e.@..e.@e..
w.e@@ee.@ee@@e@..ee..e.....ee@@.ee.w
...e.e@@ee@e.@eee@@e@@e@.....ee..@..
......@e@@.@e..@e@@ee@ee..e.....ee..
w...eee..ee@e....eee@e@@e.@...e@@..w
...e@@e..@.e@.....e.e.e...e...@ee...
...e@@e.eee..eee.e@e@e@e.e.e@ee@e...
w...ee..@@@@e@@@.@e@e@...@e..e@@ee.w
........eeeeeeee@.....@e@e.e@eeee@..
..e@e@...e@@@@@ee.....e.e@..ee@@.e..
w....ee@...eee.....e@e.e@@e@@e.ee@.w
..e@e..e.e.e...ee@e@e@@e.e.e...@.e..
..e....@e@.@e..@@ee..@e........ee@..
w.@e..ee..e@ee.e@e@..e.....e....e@.w
..@e.e@ee.e@e@...ee@e@@e.e@@e.e.@e..
..ee..e@@e@e.....@e..@e...e@@e@.....
w.e@e.@....@e.....e@@ee@e..ee@@ee..w
....@ee....e@......eee@.......e@@e..