33,36
360
360
1000
..e..e@e...@e@e..@e.e@.....@e...e@..
w.@........ee@e..e...ee@@e.e@e...e.w
..ee........e@e..@..e@.eee@e.@e.....
...@ee@.@e@.e@@e.ee....@@e.ee@e..e..
w..e@.e.eee..e@..@@e...e..e@@e...@.w
...e@e..e@....eeee.....e....e@e..e..
.......e@e...ee@@e@eee.@e....e@e....
w.....@e@@e.e@@e@e@e@@e..e@ee@e..e.w
......e@e.@.e@@ee@@ee@e.e.e@@e@@e@..
..e@...e@.e..ee...e@@e@e@e@e@e.ee@..
w.@e..e@e.@ee@......@e.@@e.e@@e@.e.w
..@e..@e.e@ee@e@...ee@.eee@eee..e@..
..e...@e@e@ee@.e@..@e..ee@e@@e..e@..
w.....e.ee@..e@.e...e@e@@..e@eee@e.w
..........e@.ee....e@e..ee....@@e...
...e@e..e@ee.@@...e@e....@eee@e@e...
w.e@@e....@..ee@.ee@@...e@.@e@e@e..w
....e.e@e.e....e.@eee@e..e..@e...e..
......@eee@...e@..e@.....e@.....e@..
w.e@e.@e@@ee..e........ee.ee....e@.w
....@.ee@e@@e.@e@e....e@@..@@ee@@e..
..e.e...ee@e.eee@e.....@e@.ee..e@e..
w.@.....@e@ee@@e.@e....e.e.ee......w
..e.....ee@@@......ee.e@e@.@@e@@e...
...ee@...@eee......@@...e..e..ee.e..
w.e@eee@@ee@e..@ee@ee...@eeee.e@e@.w
..@e@..ee.e@@e.e.@...e.e@.@@@e...e..
..@e@e@ee@.e@....e...@e.e.ee@ee.e@..
w.ee@@e..e..e@e@e@.e.e@e@.e@..@.@..w
..e.e@e.....@e...e.@e.....e@e.e.e...
..@ee@@.e@......e@..e.e@..ee@.......
w....eee.ee...@e...e@..ee.@@e....e.w
.....e@@ee@.e@e.........@ee@e...e@..