33,36
356
356
1000
...e@e.@e.e@@e.....@e..e@......e@e..
w.e@@eee@e.ee@.e...e@...e@...e@e...w
..e.ee@.e@.e@e.@ee@e....@e....e.....
..@...e@@e.@e@e@..e@.e..e....e@..e..
w.e...@e.e@....e..@.e@.e@..eee..e@.w
...e.e@..ee....@e@e.e@e@..e@@@e.....
..e@@ee..@e.e@e@e.@@ee@@e@@ee...e...
w.@@e.........e@e.ee.e@e@e@@@e.e@..w
..ee...@e......@e@e@......ee...@ee..
....e@ee..e.e@.e@@e.e.....@.ee@.e@..
w.....@ee.@e@e.@eeee@.....ee@@e....w
...@e...@........e@@e.......@e..e@..
...e.e.ee.....e..e@e@eeeee..e...@e..
w..ee@e@@eeee@@e..ee.@@@@@e..e.e@..w
...@e@e@ee@@ee.....@eeeeeeee@@e.e...
...........e@.e@ee@e@@..e@@ee@......
w.@ee..@e.....e@e....e.ee@@e.e.....w
..e.@@ee@e......e@.e...@.ee@....e...
....ee@..@.....e.ee@e@.e........@...
w...e@e@eee@.e@@e.@@ee@e@e.e@...e..w
....e@.e@.@e.@e@@eeeeee@@e.@ee@.....
..ee.e@..@ee@e.ee..e@@e.eee...ee.e..
w.@@..e..e.e@@e.@ee.e@e..@@...e@.@.w
..ee....@e.ee@ee..@@ee@..eee@e.@ee..
.......@e.e@@e.@e@ee.@e@e@e@...e....
w..@ee@e...e@.e@@e.e.e.ee@e........w
...ee@....e@e.@e@ee@.@e...e@e@.@e...
..e@e@e...@e..e..e....@e..@e.e@e....
w..e@e@e@e@e.e@..@ee..@e@.@ee@...e.w
...e...@e@@e.ee....@e.e.eee@.....@..
...@e...e.ee@@@e..e@e...@@e.....ee..
w.......@ee@ee@@.e..ee..e......e@@.w
........e@@e..eee@.e@@e.e@e......e..