33,36
367
367
1000
....e.e@@e.e@ee@e...........@e......
w..e@.@ee..e@...ee.e@ee.e...e...e@.w
............eee@@@e...@e@...e.e@.e..
...ee@ee...ee@.ee@.ee@ee@e.e@..e....
w..@eee@...@e...@ee@@e.e@e.e@ee.e@.w
...ee@.....@eee@.@e@e..e@e@e@e@.@e..
...@e@e....ee@.e.e.e........e@......
w.e@e..e.@ee.....@e@..e.....@e..e@.w
...@e..@eee@e..@ee.e.e@.....e@.eee..
...eee.e@e@ee@.e..e@@e..e@e@e@e@@@..
w.e@@@e@e@e@ee.ee@e@e@..e@..e@e.ee.w
..@.ee@.e@.e@.e@@e..e@e.@ee.@e..e@..
..e.@e...ee@@ee@@ee@e...e@@e.....e..
w..e@e....e@e.@ee@@@e.......e....@.w
..e.....e@ee@.....ee....ee@.@e...e..
..@eee.eee@@e.....e@...e@.e.e@.e....
w..e@@e@@@e....e@e..@e.@ee..e@e@...w
...e@e@.e...ee....e@e..ee@e@e..e....
...e@....ee@@@eee..ee@e@@@e....@....
w...ee@ee@@ee@@@@e@@e@..ee@...ee...w
...e@@...e@e.eee@eee.e..e.@e..@e....
..ee@e.e@.e.@ee@.e@..@e.@.e.@e@e@...
w.@e.e..e@@ee....e@...e.e...e@e.e..w
.....@e..e........e..e@..e..........
....e@e.e@e......e@.e@@e@@ee..e@e...
w...e@ee@e@e.@e.ee@..@e@ee@@e....e.w
..@e...e@e@@.e@e@.e..e......e@ee@@..
..e@..ee@eeeee@.@e....@e....@e..ee..
w.....@e...e@@e.e.....ee.@e.e@e@e..w
........eee@ee...e@e...@ee@.e@.e@...
...e@ee.@@..@@@ee....e@@e....e......
w..@e@@eeee.eeee@.e..@ee@e@ee.e@@e.w
......e@e@@e.....e@...@e...e@.@ee...