33,36
365
365
1000
.....e@e@e...e@e.@ee@e@e@e@e........
w..ee.e.e@...@ee.e..e...e.e@..@eee.w
...@@........e@@e.........e@eee@@@..
...ee...e....@e...e.......@ee@e@ee..
w....e.e@@e..e@...@....e@.e@@@e@.e.w
..e..@ee@e.e@@@e..e.e...e..eeeee.@..
..@.........eeee@eee@....e@@e.@..e..
w.e..ee@......e.e@@e@..e@ee@e@e@e..w
..@e@@.ee@e@ee@e@e.ee.e@.e@e@.......
....ee@@e@e@@.ee@@e@..e.........e@..
w.e...e..e@eee@@e@e...@e....ee...e.w
..@..e.....@ee@@e.@e@e@..e.e@@ee@e..
..e..@..e.....ee.e@ee.ee@@..e@ee@e..
w...ee..@eee@e...@e@..e.ee.e@@e.e..w
....@@..e.@....@e@e.e@@eee.@ee@.@...
....ee.e@.e...eee.@..e@@@@e..@@ee...
w..e...e@....e@@@@e...eee@e@.ee@.e.w
...@ee..e...e..eee.ee.....@ee@..e@..
....e@e....e@.e.e@.@@.....e@..e.e...
w..e@e.e......@e...ee........e@.@e.w
..e@.@e@....e...........ee...e@ee...
.....e@@eeee@ee@e.......@@eee.@e@...
w....e@e@@@e@@e...e@e.e.e@e@@.e....w
..e@ee@e@e..e..e...@ee@...@.e.e.....
..@e.@e.@e@e.ee@.e@e......e@e@@ee@..
w...@e..e.eee@@ee@...e@e....ee..ee.w
....e@..@.@@@.e@...ee@eee...@..e@...
....e..@e.eee@e@@ee@.e@@@e..e...e@..
w..e@e.ee..e@@eee@@ee@@e...ee.e..e.w
...@@e.e@....e.@ee@e..ee.e.@@e@.e@..
...ee..e@.ee@..ee@e...e@.@ee..e@e@..
w......ee@@.e.e@e@@...e@ee@.e@ee.e.w
...e@ee@.ee@ee@..ee.e@ee@....e@@e@..