33,36
359
359
1000
...e@e.e@..ee...e@e......e@e@e@.....
w..@e..@e.e@@e....@e@e@e@...e.ee@e.w
...e@...@e.e@e....e.eee.eee@e...e@..
...eeeee.ee@ee....@..@e.e@@e@e...e..
w.e@@@@@e@.e@@e@..ee.e@e@.@e@@e.e@.w
....eee@....e@ee..@@e@e@..e.e.@e.e..
.....@.e.eee@..e..e@e.e@e.e@e@e.e@..
w...ee.e.@@@e.e@@e@e@.@e...ee@@ee@.w
..e@@@e@.ee..e..e@.e@e.....@ee..@e..
...eee@.....e@e@@e..e@@e.@e.e@e.....
w..e@@e..e@e.e@e..e@..e@.e....@....w
...eee@..@e..@ee...e....e@..e@e.e...
..e@@e.e@e....e@@e..e...e@e@e..e@...
w..e@@.e@@e...@.e..e@e.e@e@.@e..e@.w
...@ee.@e...e.e....e.@e...@e@....e..
...e@@e.....@....e.@e@..e.e.e.......
w.e@...e@e@ee@...@e..eee@e@..@e....w
..e@e.......ee...@e..e@@@e.e.ee.....
...e@...e@@e@.ee@e.e.e@ee..@e.@.....
w.e@e@e.@ee..e@ee@e@.......@e.e....w
..@e...e@e@.e@e@@e...e@e@..e...e@e..
...ee..e@e..@@e..@......e...e...e...
w.e@@e.eeeeeee...e.........e@..e@..w
..e@e.e@@@@@...e.....e@e..@ee@e.e...
..@@eee.eeee...@eeeee.....e.@e@.@e..
w.eee@@e@..e@....@@@@e@e..@e@e@ee@.w
.....e@ee...ee.eeeee...@ee@e@.......
....e@@e@...e@.@@e....e@e.e.e.e.....
w..e@@e.e.e@e@.e@ee.......@e@.@e...w
...e@e.e@..e.e@...@e.e.@e.e.e@e.....
...@e.e@......e@e@...@.e...e@.......
w.e@e...e@e@@e@e.e...e....e.ee@e.e.w
..@e....@e.eee@e.e@ee@...e@e@...e@..