33,36
368
368
1000
..ee@e@.e...e........e@.e@...@e.....
w.@e..e@@e.e@@e..e...@ee.e...e..e@.w
..e@..@e....@e@e.@e..ee@......@eee..
....@e...ee.e.e@..@ee@....@e..e@@...
w..@e...e@@e........@.e...e.e.e@e..w
...ee.e...e@.e....e@ee@.....@ee@ee..
..e@@e@...@e.@e.e@e..e@e...e@@.e@@..
w..e...e.e@eee...@e.ee@e...@ee@e.e.w
..e@...@.@@e@@e@@e..@e@...@e..@e@e..
..e.@e@e.ee@.@eee.ee..e.e@e...e@@e..
w.@eee@@@e...e.@ee@@e@ee@.......e..w
..@e..eee@@e@ee.e..@ee@...e.........
..e....e@.e...@.@eeee.....@e.ee@....
w.e..@ee@e.e..ee@@@@@e@e....e@.e...w
..@e@e..e.e@e.@@eeeee@......e@.@e@..
..@ee...@e@e..eeee@.@..e@..e.e.e.e..
w.e...e.e.e@.ee@@e@.e@eee.e@e@e@.e.w
..e..e@e....e@....eeee@@@ee@@ee.e@..
..@ee@e.....@e..ee@@@@.e..@ee@@e....
w.@e..@ee@e..@e.@@eeee.......e@eee.w
..e@..@e..e@...@e@ee....e.@e....@@..
......e.ee@e..ee...@...e@.e.@e..ee..
w.e@e..e@@e...@e.e@e@..@e@eee..e@@.w
..e@e....@ee@e@.....e..e...@e@...e..
...ee....e..e@e.e..e@@e..e@e.e.e@@..
w.e@@e.@ee.....e@....e..e@e.....ee.w
...ee@.ee@.@ee..e.e@eee...@e.e......
..e@@e..e@.e.@..@e..@@@e.e...@e..e..
w.e@e.e.@e...eee@e.eee.e.@e@@e.e.@.w
..e@..@e.e@..@@e@ee@@@.@...ee..@ee..
...ee.....ee@e.e@@..ee.e@@e.@e@@e...
w..e@.e@e..e@e.@ee@e....ee.e.eeee..w
.......e@..@e....e@e....e@e@.@ee@...