33,36
365
365
1000
..@eee@e....e@.......e@@ee@e.e.e@e..
w.e@@e@e..e.@e.e.e.e..ee.e@@.@e@ee.w
...e@e....@....@.@.@..@e.eee...@e@..
...@..e@e.e.e@ee@eee.e..e@.ee.ee....
w..ee@e@@.....@e..@.e@...e@@@e@@ee.w
.....@eee.....@e@@e.e@eee.eee@@e@@..
..e..e...e@..ee@ee....e@@...@ee..e..
w.@e..e@e.e..@.e@@......e@.e@e..e@.w
..@e@e.@e....e...e@.ee...e..........
..ee...e..e@e...e.e@@@ee.e.e@ee@e...
w.@@e@..........@.eee@e@.@e.e@@e...w
..ee.e.e@.e.e@e.e.@e.@e.....@.......
........ee@@e.....e@.e..e.e.ee......
w...e@ee...ee@e.ee@...e.@e@.e@@ee..w
...e..e@e....e@e@@e...@e@e...ee@@...
..e@..@e...ee@ee@@e...ee@@.e@@..e...
w.e@e.e@@ee@@e@.ee@.e@e.ee..ee.e@..w
....@e@.e..eee@e.e...@e....e..e@....
.....e@e..e@..e@e@...ee...e@..@e....
w..e..e@..ee.e@e..e.e@@........e@e.w
..e@@e@...@@e@..e.@e.@e..ee...e@....
....e.....e@@e.e@.e..e..e@@e..@.e@..
w..e@...@e@e......@ee@...e@@e.e..e.w
...e@e..ee@....eee.e@..e@ee......@..
...ee..@e@ee@ee@@@.....ee@ee..ee@e..
w..@@e.e.e.@@ee@ee.ee@.@e@@@@e@@e..w
...e@e..e@eee.@e@.e@.ee@@eeeeee@....
..e@@e.e@.@@e.......@e.e@.@.e@.ee@..
w.e.ee....e@@@e.....e...e.ee@...ee.w
..@ee@..e@.eee...e.e@...e@......@@..
..@ee.@e@e.@.@e..@e.....@e..@ee.ee..
w.ee@@e...eee@@ee@e...ee.ee.e.@.@@.w
...e@ee@e.@e.e@e...e@e@@e@@e..e.ee..