33,36
359
359
1000
....e..e..e@.....e@e..e@.@ee@ee.....
w...@.e@...e.......e@e.e.e.ee@@..e.w
....ee.e...ee@.e@eee@ee@.@e@e@e.e@..
..e..@.@e.e@@e...e@.@ee@ee@.....e@..
w.@@ee@e........e.e@e@e@e......e.e.w
..ee@@@ee.....e.@..@e.@e.......@....
.....ee.@...ee@.e@ee...@...e...e....
w.e.e@..ee..@e@e.e@@eeee@e.@e......w
..@.e@eee@..e......@e@@ee@e@e.......
..ee..e@@e.ee..@e..e.e.ee.@@e...e...
w.@@......e@@e@e.....@e@@.ee..e@@..w
..ee@e@....e@@e...e...@.e..e@e.ee...
...e..e.ee@@e.eee@@e..e@e@ee@e@e@...
w..@e.@e@@e.@e@@.e@eee.e@e@..e@ee@.w
...e@..e@e@.e..e@@e@@@e@.e@.e@@e@e..
...@e.eee...@ee@e..@eee@..e...e.....
w.e@..@@@e.e@.@e@..e..eee.@e.......w
...e@@ee.e.@eeee@ee.@e@@@ee@@e@e@...
...@ee..e@..@@@@@e@.ee.e.e..e...e...
w....@e..@e.eeeee..e@@e.e@....e....w
......@e.e..@e...e@.....@ee@e.@ee@..
..eee......e@e@e.@ee@ee@@ee@e.@e.e..
w.@@@ee@eee..@..@e.e..eee@e@@ee.@e.w
..ee@e..e@@e.ee@ee.@ee@.@e.e....e...
........e@....@e.@ee@..e@ee....e@...
w.e....eee..e@@ee@e@...@e@@e..e@@e.w
..@e..e@@e@..ee.......e@e.e@ee..e...
..e..e@e..e...e.e@e@e.....@e@@ee@...
w.@ee@...e....@ee@e@e.....e..e..e@.w
...@e...e@@e.@e..ee@e.ee@e..e@..@e..
....e.e...e@.e........@@@e.......e..
w..e@.@ee@e..........eeee..e@....@.w
...@e.....@e.....e@e.@ee@...e....e..