33,36
375
375
1000
...ee@ee@.......e...e@e....@e...e@..
w.e@@e..e..@e..e@.e@e....e.ee....e.w
......e@@e.e.......e..@e.@.e@...ee..
....e..e@....e..eee@..e.ee@@....@@..
w.ee@.e@e@e..@e.@@e@....@eeee.e.ee.w
..@@ee@......e@.e..e..e@e..@@e@.e...
..e.ee..e.ee....@e...@e@@e.e.e@e@e..
w..e@@ee@e@@e...@ee..e.e@ee@..eee@.w
........e.@e..e.e@@e....@e....e@@e..
..@e...e@.e.e@@eee@e..e.e..e@.e@ee..
w.ee@e.e@e..@e@.@.@ee@@e...@e.@..@.w
....e@e.e@ee@ee.e.e..e@ee@.e@.e..e..
...@e@@e.e@e....@.@e.....ee@..e@e@..
w..eee@@e@@e@@e@ee@e..e@eee@...e.e.w
...e@@e...e.ee.e......e@@@ee.e.@e@..
...e@e...e.....@e.....@ee@e..@eee@..
w...@ee.e@....e@e@ee@..@e@@......e.w
....e.@e@.e.e@ee@e@.ee.e.ee@...e@e..
.....e@...@.ee@.....e@.ee@.e.e@e....
w..e..e.e.e.@.........e@e@.@@e.@ee.w
..e@..ee@...e.....e@e.@e@e.ee...e@..
..e@e@@.ee......ee@eee@.......e..e..
w.@e.eee@@e@@e.e@@e.@ee...ee@.@ee@.w
..e..@ee@e@ee@@ee@@@e@ee@e@.ee.@e...
..@e.......@..e.@eee..@ee@.ee@@e....
w.e@@e...e@e...@e..@.e@@e@e@..e....w
....eee....@e..e...e@.e.ee@@e....e..
....e@@eeee@e..e@e..e.e@@e@e.e...@..
w.e@@e@e@@e.e@e.....ee.e...e@@.eee.w
...eeee@......e.e@ee@@eee.eeeee@@e..
....e@..@ee@e@@...@e.@e@@.@@e@......
w..e....e..e@eee@e@e.e..eee@e.ee...w
..e@..e@e.e@e...e@......e@...e@@e...