33,36
359
359
1000
..e..ee........e@e.@e...e@@e........
w.@e@@@..e@e.e....@ee@e@eee@e@...e.w
..@eeeee@ee@e@e@e.e.....e....ee..@..
..e@.@@ee@@e@.e@ee@.....@e..e@@e@e..
w....e.@e@....@.e@@e...e@@e..@e@...w
.......e.e@e..e.e.e...e.ee.@ee......
.....e.e@e@..e@e@e@...@e@@.e...e....
w....@ee..e.e..@@e@.e@e..e.e@ee@...w
...e.e@@e..e@.@ee.e.@e....eee@eee...
...@e.e@..e@@ee......ee@.e@@ee@@@e..
w..e@..e....e@..e....@@e..e@@e.e.e.w
...e.e@@ee.....e@.e..e@@@e.e.e@.e@..
..e@eee..@e..e....@e..eee@e@e@e.....
w.@ee@e.....e@e@eeee....e@@.@...@e.w
..ee@.@e@.e@@e@ee@@@e@@e.ee.e@@ee...
..@@ee@ee@eee.e@e@ee@ee...@e.ee@....
w.e....e@..@e.e@@ee@e.e...e@.@e@e..w
...ee@e...e@@e@e..@e..@e..e@@ee@e...
...@e@.....ee@.....e@.....@eeee..e..
w..e@e@ee@e..e@e....ee..e..e.@@e@@.w
...@@ee.e@e..@..ee..@@e@@ee@.ee@ee..
...ee.@.@e@..ee@@@e.e..e@ee...e..e..
w.....e........ee..e@e..ee@...@ee@.w
.......ee@e@e.e.e@...@@e@.....e@e...
..ee...@e@e@e.@..e...ee...e@ee@.....
w.@@@e.ee@e@e.e@..........e.e@@ee..w
..eee..e@..e@..e....e....e@.@ee.@e..
...@..ee@e@@e.@e...e@..@ee@e....e@..
w..e..@e.ee...e.....ee.ee@@e....e@.w
.....e@e@@ee@e....@e@@e.e@e......e..
....e@.@e...@ee@..e@.e@.......e@e@..
w.e@.e..e@@ee@.e........e...e......w
...e.@e..ee.e@e..e@e....@e..@e@e....