33,36
360
360
1000
.......e@ee..ee@e..e@ee@e@.e@e......
w.e@......@..@ee@.e@e....e.........w
...ee@e@e.e.e@e.e.e@@..ee@eee@@e@e..
...e.@e....e..e@@e.ee.e@@e@@eee.....
w..@.e@.e@e@@e.e@ee@e...ee@e....e..w
...e@..e.e.@e@e@ee@e@ee@@.e@....@e..
..e.e.e@e..e...e@@e..@eee.@e..e@@e..
w.@.....@@eeee@e@..@e..e..e@..@ee..w
..e.e...ee.@@e.@e@ee.@e@@e@e........
...e@......e@ee..@e.@e.@eee@@e@e....
w.......e.....@e.e..e..e.@e@e.@e@e.w
..e@@e.e@@e@..e@...ee..e.e@...e.....
...ee@..@e.e..e@ee@@@e.@..@e........
w..ee@e.e...e@...eee@e.e..e.e..e.e.w
...@e.@e....@e...@e.e..e@e..@..@e@..
..e@.....ee@e..e@e@e@@e..ee@eee@e...
w..e...e@@e....@e..e@e@.e@@..@ee...w
........e@e.eee@...e.e....ee@e.@....
..e.e...@@e.@@.e..e@e@.e.e@..@.e@...
w.@e@...ee..eee@...ee..@.....ee@e..w
..@e....e@........e@@e.e@e..e@@e....
..e....eeee@...e@.e@e..e@e..e@e.e@..
w.@ee.e@@@eee@..ee@.@e.@e@...e@.@e.w
....@@e@e@e..e...@ee@e@e.@e.........
....ee.ee@@e@@@e@...@e@..e@e@ee@e@..
w...@@e@.e@eeee.e.e@e.ee@........e.w
....e...e@e....e.@e.e@eeee......e@..
..e......e@...e@.e..e@@@.@e...e@e@..
w.@e.......e.....@e..eeee@@e.eee.e.w
..@e@e@eee.@e@e..@e..e@@ee@@e@@.....
..e@eee@@@e@e....ee@e.e@@@ee@.ee....
w....@.ee.@e..e..@.e.e.ee.....e@...w
.....e.@e.....@e.ee@e@e@@e.....e@e..