33,36
359
359
1000
..e.@e.e.e.e@.....e.e@e.e@e.....e...
w.@ee@e@e@.@e.....@ee@ee@@ee...e@e.w
..@e..e@e..@e....e@.e@e.ee.@e...e@..
..ee....@e@e..ee..e.e@@e@..e@..ee@..
w.e@e....@e...@@.e@..e.e.ee.e..@@e.w
..@ee@........eee.e@.e.@e@@e@..e....
..e..e..e.@e..ee@.@e@@e@ee@e@e@ee@..
w.@e@e..@.e..e@@....e.e@..e@e@..@e.w
..ee@@..e..@ee@e....@e.e.e...ee@....
....ee.e@.@e...@e..e@@e.e@...@ee....
w..eee@@.@e@@e..e@e.e.@.e.......e..w
...@@.eeee..ee.....@e.e.@e.e..ee@e..
...ee.@.@@e@.@e.e..e..@e.e@@ee@@....
w.@e@.e@e..e.@ee@e@ee.....e.ee.eee.w
..e@...@e.e..e..e@..@ee@e.e@@@ee@@..
....e..e@.@e..e.e@e...e@@e@ee@e..e..
w..e@.ee@....e@.e.@eee@e.e@........w
......@ee......e@ee@@@e@..e@@e......
.....e@e..e....e@@e.e@.e..@eee..@e..
w.@e.e@@e.@ee@.ee@@e@e.@e....@e.e..w
..e...e.@ee..ee@@e@.e@...e.....e@...
.....ee@ee@e.@....ee@ee.e@...e.e@e..
w.e@e@.e@e@@ee.....e@@@.e@...@e@@e.w
...e@@eeeee@e@e.....eee.@e...e@ee...
..e.@e.@@@e.@e@......e@e@@e....@....
w.@ee@.ee@..e...e.e@e@..e..@e..e...w
..@e....ee@e@..e@@ee@....e.e..e@....
..e.....@e....e@@ee@e....@e@........
w........@e....ee.@.@e..e@@e.e@ee@.w
.....e@ee@@..ee@..e......e.......e..
........@eee@@e.e..e@e..e.....eee...
w.....ee..e.e@.e@e.e.@.e@....e@@@..w
..e@ee@@ee@.@ee@e.e@.e.e@e.e@e@ee...