33,36
360
360
1000
......e..e@e@e.....e@ee@e@e..e.e@...
w...e@@@e@ee@@e.e@ee@@..e@e..@..e..w
..ee.eee@.@ee.e@ee@@ee...e@e.e@.....
..@@...e.ee@@@e@ee@ee@@e.@e...ee@e..
w.ee..e@e@e@ee..@...e@eee.....@ee@.w
.......@e@@e@.e@ee@.e@e@@e....e@@e..
....e..eee.......@eee@ee@...e@e.ee..
w..e@.ee@........e@@...@e.e..e@.e@.w
..e@.e@@e.......e.ee...e@.@e.e@e....
..@e.@@e.......e@.@e..e@.ee@...eee..
w..e.ee.e.e..ee...e@...ee@@...e@@@.w
..e@e@e@@.@..@@@e.e@e..@e@e....@ee..
..@e..eeeee@eeeee@e@e.e@.e.e@e.e....
w...ee@@e@@e.@e..e@e...e.....@@e@e.w
...e@e@@e@........e@.e@.@e...ee.....
..@e..ee.e........e.eee.e...e.@..e..
w.e......@ee@@e@ee@e@@....e.@.e..@.w
...e@.......ee@e@@@e.e..ee@.ee..@e..
...@e.......@@@e@ee@....@e@e@@e.e...
w.e@......e.eee.@e...e@.ee@....e@..w
...ee@....@.....e.e..@e...e.e...@e..
....ee....e..@e...@...ee@e.e@e..e...
w...@e.e.....e....e..e@e@e.e@@.....w
....e..@........ee..e@...e@.ee......
....@e.e@@e...ee@@....@e@ee@ee......
w.e@e..eee....@.@e.@e.ee@..e@@e@e..w
....e@.@......e.e..e..@@ee@eee.e@e..
.....e.e..ee@e@@ee....e@.@ee@e.e@@..
w.e@.@.@e.@..@.ee@e...@e.ee@e@..ee.w
..@eeee@eee..e..@@e.@ee@e@@e....e...
....@@@@e@.ee...ee..e.@e..e@..@e@...
w.e@eeeeee@@@e.e@@e@e.....e@e@ee...w
..e@e.@e@.ee@e...ee@e@e...@e.e@@e...