33,36
357
357
1000
..@e...e.@e@ee@e..e@e@ee...e@e.@e...
w.e.ee@@@e.ee.....e@.e@@@e.@e@.e...w
....@@eee@e@@..e..@e..@eeee@e..@e...
..e.e.....@ee..@..e.eee..@e...e.....
w.@e..e@..e@@e.e.e@e@@e@..e@e@@e@..w
.......e........ee@@e.@e..ee.ee@ee..
..e....@..e@..e.@ee@.....e@@...@e@..
w.@ee..e...e..@e@@.e..e....e@e@e...w
..e.@....ee...e@ee....@...e@@ee@.e..
..@@e...e@@@e.e.......e@e..@e.@e.@..
w.ee@.e@e.ee..@ee@e..e@....e@e...e.w
..ee@@ee.e...........@e......@e.e...
..@eeee@.@.....e@e...e.e@e@e....@e..
w.@e@@...e@.e..e@e..e@........ee.@.w
..e.@e....e.@e.e@...@eee.@eeee@@ee..
....e..e@.@e@e.ee.e@e@@@eee@@@ee@...
w....@e.eee@@ee@e@....e..e..e@..e@.w
...e@e..e@e@e.@.ee.e.....@e.@e...e..
...e@e..e@e@e@ee@e.@....e@e...e@....
w..e@.e..@e...e@e@.e.e.e@ee@e.@e...w
....ee@..e@e@ee.e....@e@.@.e@.e@@e..
..@e.@.@e.eee@@e@....e@@ee.@e..ee@..
w.eeee.e@.@@ee@e@e.ee..ee@...ee@...w
..e@@..e@eee.eee..e@@e....e.e@@ee@..
....e..e@.@@e@@@ee@@eee...@ee@e..e..
w...e@e@e@e...ee@..e.@@ee@@ee@@e.e.w
.....e@..e@.e..e@.e@ee@@eee..e..e@..
..e@e...e.@e@..ee.ee@.e@..ee....e@..
w.....ee@.ee@e.@@e@....ee@@@e....e.w
....e@@.e@@ee@.e....e....ee....ee@..
..@e.ee@.e@.@e..e@.e@@e........@....
w.e....e..e@e....e...e@e@e@..e@e@..w
..@e......................e.....e...