33,36
365
365
1000
...@e@e..e@.....ee@ee....@e...@e@...
w..e.@e@..e....e@@ee@e@.ee@ee@e.ee.w
..e@.e.ee@.e@ee@.e....e.@e@@e@e..@..
....e....ee@e....@@e.....@ee..e@ee..
w...@e@e@@@e.....eee..e@ee@ee......w
..e@ee@eeee@.....@e@e..e@.e@@.......
..@e.e@@e@@e....e@e.@e..e...e....e..
w.@ee.ee@e..e@ee@..e@.e@@e......e@.w
..ee@e@e@@.........ee..e@e@e@...e@..
...@...@ee.......@e@@e.e@@e.e..e.e..
w..e.e@..e@eee@e@e...@..e..e...@e..w
....e.e..@e@@e..@e...e@eee.@e..e@e..
....@e@e..e@@eeee..e@@ee@@e...e@e@..
w..e@e.@e..ee.@@e.e@ee@.e@e..@e..e.w
..eee@.e@e@e..e@@e@.@e..e@...e.e@@..
..@@@@ee@@@e...ee@..e....e@e....ee..
w.eeee.eeeee@e..e@ee@..e.e.e@@e....w
..e@@.e@@ee@@ee.e......@e@@eee..@e..
..e@e.e@@ee@e.@.@e.......ee.e@..e...
w.@.eeeee.e@.@eee@....e.e@@ee......w
..ee@@@e...e.ee@@.....@...e@@e..e@..
...e@e.@e..@...@e.....eee@@e...e.e..
w..@e..@e.ee...e.e.....@ee....e@...w
..e@e..eee@e...ee@.......e@e....@e..
..@e...e@@e...e@@e......e@@ee@e@e...
w....e...@ee@e.@ee....e@e@e..e@e@..w
..e@e@@e.e..@e.e@@...e.e...@e.eee...
..@e@.e..@..e....ee@.@e.@e.e..@@@e..
w.ee@@e@ee......@e.e@e..ee@...ee...w
..@eee.@e@......e@..e@.e..ee@e@.....
..e@..ee.e@@e...e@@e@..@...e@.......
w....e@ee.eee@...ee....ee@e@ee@e@e.w
.....@ee@....e...@e....e@..e@.e.....