33,36
350
350
1000
...e@.@e.e@@ee...e@ee@@e@.....e@e...
w.eee.e...ee.@e@...e.ee.e@....@e...w
..@@e.@e@ee@..@ee@e@..@e.e.e..@e....
..e.e@e.e@@e..e@..ee...@e.e@.ee.e...
w.ee@...e@e.e@@e..@@.e@e....e@.e@..w
..@@e..e@@eeeee@..eee@.e@e..@@e@....
..ee@.e..ee@@e@@e......@e@..eeee....
w..@.e@e.ee@@e@ee@.e.....e@.@e@@e..w
..ee@@..e@@ee...@e.@..e@.@e@e.e@....
..@eee.e...e@.ee.e@e@e.e..e@@e.e....
w.....e@.....e@@..e..@.e...e@e.....w
..e@..e@.....@@ee@@e@e.@e.e@.@ee@e..
...e...e.....ee..e.e..e@e..e@e@e@e..
w..e.e.e...........@.......@e...e@.w
..e@.@e@@e..e..ee..e....e.e@e@e@e@..
..@e....ee@e@ee@@e....e@@e..e@.e.e..
w.@e.e@e..e@e@..e@.....e....@e.@e..w
..e..e@e@ee@e.........e@ee..e@......
............e...e@@e....@@e@ee@ee...
w.......ee@e@....ee@....ee@@e..@@e.w
.....e.e@@e..e@e.@e@ee..@e.ee..e@...
..ee@@e@e@..e@..e@e..@e....e@eeee...
w.@eee@..e@.@ee..@e.e@.e@e.@e@@@e..w
..e@.e@.e@e...@e@eee@e........e@@e..
..e.e.e...@e@ee..@@@e......e...e....
w.@e@@ee@e.@e@..eee........@e......w
..e@@e.e@e@ee@ee@@.....e@e@e........
....e.e@@ee@.e@@@e.e.e..@e.@e.......
w.....@ee.e@.@eeee.@.@..ee@e.ee....w
...e@e@.e@.e.e@.e@.e.e.e@@e@e@@e....
.....ee..e..e....e@.e@e@.ee@e@......
w.e.e@.e@.e.@e....e@@e.....e@e.....w
..@ee@e.ee@........ee@.........e@e..