33,36
357
357
1000
.....@e...@ee..e@e.......e..e@e.e@..
w.@e@e@.e@ee@.e.e...@e..e@.e@@e..e.w
..e....eee..@e@.@e..e..e@e.e@ee.e...
.......@@@@eee..e@.@e@.@..e@.e@e@...
w...@e.eeee.e@e..e.e@e.e..e@ee@e@e.w
....e...e@@...@ee@e........e@@e.e@..
...e@.....e.ee@@@e.e...e@e@e@e..e@..
w.e@...e....@@ee.ee@@e@@e.e@.e..ee.w
..e@e..@e@e@e....@e@eee@@.@e.@..@@..
.......e@@e@..@ee@e.@@eee.@e.e@eee..
w........e.e..e.@e..e.....eee@@e...w
..e@e.e..@....e...eee@e...e@@@e.....
..@e..@e.e.e..@e..@@@e...ee@ee.e....
w.e@.......@ee@e@eee.@e..@e@e.e@ee.w
...e.e.@e.e@e.e@........eee@e@ee@@..
...@.@.e...@e..e.e.....e@@e@ee@@.e..
w.eeee@e.e.e...@.@.......e@.@e.e@..w
..@.@e@..@e..e@e.ee@e.e@...@e@@ee...
..e...e......@e..e@@e..e@e.e.@e.e@..
w....e@............e@e.e...@@e..@e.w
...ee..e.....eeee.e@.@e@...ee@......
..e@@..@e....@@@@.e..e@@eee@........
w...e.e@.....eeeee@@ee@ee@@.@e@e.e.w
.......e...e.@e.e..ee..@..e.e..ee@..
....ee....e@@e@e@...@e.e.......@e@..
w..e@@eee.@@ee@e@...ee....e@e..e.e.w
..e..ee@@.ee..eee..e@@e...e@ee.@e...
..@..@@eee.....@e..e@@e....@e@......
w.e.eee@.@e.ee..@..@eee..e.e@.e@e..w
..@e@.@e..ee@@e@e.e@e@@e@@e.ee@e....
..@e..ee@e@e.e@...ee..e@ee@e@@@e....
w.ee@.@e@@e@@e....@e.....@@e@ee@...w
...@e.e.ee..e...e@e......ee...e@e...