33,36
365
365
1000
..e@e....ee@.e@e@e@e..e@e..@e.e@e...
w.e@....e@ee.@......ee@ee@.e..e@e..w
...e....e@@e.e..@e..@@ee@ee@..@e....
..e...e..e...e..ee@ee.e@e...e@@e....
w.@e..@ee..ee@@ee@@e.@e@@ee.eee....w
...e@.e@@..@e.e...e@.e.ee@@e@e......
....eee@e..@ee....ee.eee@@eee@..ee..
w.e.e@.....e.@@e..@@e@@e.e@@e@ee@@.w
..@e.e....@e.ee.e.eee@e....e@..@.e..
..@ee@..e@e...e.@e@@@e@.e......e....
w.e@........e@@e.e@e.e@e@..e..e@.e.w
..e@.........e.e@@e.e@ee@..@ee..e@..
...e.eee.e@e.@.@e.ee.e@ee.e@@@e.e@..
w.e..@@@e..eee.e.e@@...@...ee..@ee.w
..@.eeee@.e@@@e@@eee...eeee@..eee...
..e.@..@..@@e...e@@....e@@e..e@@@e..
w...e@.eeeeeee..e.e@e...e@e....e@e.w
....@ee@@@..@@ee@ee@@e.e@@e@...ee@..
........ee..e@ee@@ee.@.@ee@e...@e...
w........ee..e@.ee...e@.......e@ee.w
....e@e.e@@e.@ee@@e...e...e..@e.e@..
..e@ee.e@...e@@.e@.e@..e@e@e@ee@e@..
w.e@@@e@@e...ee..e..e..e@e@e@@.e@e.w
...eee..ee@.......e@.e@@e@e.ee@@e...
....@e....ee@......e..e.......e..e..
w....@e..e@@e@e..e@e..@e@e@e..@..@.w
..e@.e@.......@.ee@@@e..e..@e.e..e..
...e...e.....@ee@@eee.....e@e.......
w.e@...@.e...e..@e.......@e..e@e@e.w
...@ee@e.@ee@ee@e..ee.e..e....ee@...
...e.....@e@ee..@ee@@e@..e....@ee...
w..@e@e..e.e@@....@e@@@e.@ee....e@.w
...e@....@e..e......eee...e@e@e..e..