33,36
345
345
1000
..e@@e........e@e...e.e@e....e@e@e..
w..ee.@eee..e......e@..@e..e..ee.e.w
...e@.e@@@e@@e...ee@@e@e@..@...@e@..
...@..@ee..e....e@e@ee.e@..e..e..e..
w.ee@e..e@.e@e@ee@e..@e.e@e...@@e@.w
..@e@e..@e.e@e..@e@.e@e..e@...eee...
..e@@ee..@e@@e.@e.e..e@...e..ee.@...
w..@e.@..e.@e.@e..@...e...@.e@@ee..w
...ee@e@.@ee..e@.ee..e@...e@@e.@@e..
..e@@e.e...e.....@..e@e....e.@ee.@..
w...@ee@..e@e.@e.e..@e.....@.e@..e.w
....e.@..e@@eee.e@.e@eee..ee........
..e@@ee@...e.@@e...@@e@@ee@e@ee.....
w.@e...eee...e@e@e.ee.e@@@e@e@@....w
..e@...e@@ee@.e@.@@e...ee.e@e@e.....
...........ee.@eeee.e...e..e.@ee....
w..........@e.e@@e@.@e..@ee@.e.@ee.w
...e@e......@....e..e@...ee@e.e@e@..
..ee.e@.....e....@...e@e.@e@@.e@e...
w.@@e.e.....e.e@.e.e@e....@ee......w
..e....e...e@@ee.@e@e@.e..e....e@e..
.......@e....e@@ee@eee.@ee@e@e.@@e..
w....ee@ee.e@ee..@@e@@ee@e@@e.eee..w
.....@...@...e@e.ee.e@ee.@e@@e@.....
..@e.ee@ee..e.e@....@..@e..e........
w.e.e@..ee.e@.@e.e@ee.e@ee...e.....w
.......e@@e@@e..@e.@.e...@@ee@......
....e.......e@.@e.@ee@@e@ee@@ee.....
w..e@e.e@.e@...e@@e.@ee@.e@..@@....w
.....@e.e..ee.@e@e@..@e.e@...ee.e@..
....e@@e@...@ee..e@...e@e..e...e.e..
w.e@ee......@e.e@.e...e@e..@...@e..w
...e@@e.e@e.e@..e..e@e...e@e...e@...