33,36
363
363
1000
..e..@e...e@e.e@e.....@e....@eee@e..
w.@..eee...e@@ee@...e@e@@ee@ee@.e..w
..e.e@@@e@e.@e.@e....e.ee..e@e@.....
..e.e@e@ee@.ee@ee..@ee@e...@..e.....
w.@e@.e.e@@e.e@e@e@e.....e.e.......w
..ee.e@..ee...e@@e@e..e.e@e@..e.....
..@@.@ee.@.e@e.@e@..e@@e.ee..e@.e...
w.ee..e@@e.e@e.ee@e.@e@.e@@@ee@e@..w
...e@e@.ee@e@eee@e@...e.eeee..e@@e..
.....e....@ee@@@e.......@@eee.@eee..
w.e@.@..@ee@..e.e.......e@e@@ee.e@.w
...e.e..e......e@......e@.e..@@ee@..
........@......e@e..e@ee@e@..e...e..
w.....e.ee.....e@ee..e@@e@.ee@ee.@.w
....ee@e@@.e@.....@........@e.@@.e..
..e@@ee@@e@.e.eee.e.......e@@.eee@..
w.ee.@e@e.e.e@@@@.....e...@ee....e.w
..@e@e@e@.e.@eeee..e@e@....@e...e@..
..@ee.....@e..@e..e.ee@@e.e@.@e.....
w.e.@@ee@e@....@e@@..@ee...e@ee.e@.w
....ee..@eee@...eee...@@e..e.e@@ee..
....@ee@e.@.e..e@@e...e@..e@.e@e@...
w..@e@e@@.e.e..e@@e.e..ee@.........w
..ee...ee...@e..ee..@ee@.ee.........
..@.e....e@.....e@..e@@@ee@e@..@ee..
w.ee@@e.e.e......e@.e@ee.@e@e..ee@.w
..eeee@e@....e@@e@ee.e.@.e...e@ee@..
..@@@e.e@ee@e.ee...@e@@e.@e.e@..ee..
w.ee.....eee@@e...e@..e....ee@..@..w
........e@@eee.....e......e@.ee.e...
.........@e.@e....ee....e@@e.e@.....
w...e@ee@e......ee@@.ee..ee........w
.......@e.e@ee@e@@eee@@e@e@e@e@e@e..