33,36
363
363
1000
....e...@e.e..e..eeee..e.e@e@..e....
w.@e@...e..@e@@@e@@@@e@@e.e.e.e@...w
..ee.@e....e@eee..eeeee@e.......e...
..@@ee....@ee@...ee.e@@ee@e.e@ee@...
w.e..e@e@ee@..e@e@@ee.@e.@e....e@e.w
....e@..e@.e.ee....@@ee..e...e@e....
..........e@e@@....e..@e@....e@e....
w....e...e@...e@e..e@e.ee.......e..w
....e@.e@e@......e@@e.e@@ee.e@e.@e..
..ee.e@e.@e..e@e.@e..e.e@e@..e@e@e..
w.@@e@e@.e......e..e.@e.e@e.e@e.ee.w
..ee@..ee@...e..@..@.....e@e@e..@@..
..e.ee.@@@e..@..e..e.....@@e.@..ee..
w.@e@@eeee...e.@e.e@....@eee@e@....w
.......@ee..e@ee@.@e....ee@e@ee@e...
....e@e@@@ee@@eeee..e...e@.@ee@e@...
w....e.ee.e.@ee@@@e.@e...ee@e...e..w
..e.e@...e@.ee..e.@e@...e@..@e.e@...
..@e@.@e@e@e@@ee....ee@e@.e@@e.e@...
w..e..eee@..e@@@e..e.e..e@.ee...e..w
...@ee@@.....eeee@e@e@.e@e.@e@e@....
.....e.e....ee@@e@e.e@..e@..@e.ee...
w.e@e@e@e..e@@e@@....e@e@..ee@e@@..w
..@....e@e..e@eee..e...e@e.@@e..e...
..e..e.@e@e.@e@....@e..e@..e@e...e..
w....@e.....e.....e@.e..e@..e@@e.@.w
...e@@e...e.@e@e...ee@e@ee.e@ee..e..
....ee.e@e@e..e@.@e.ee@.@e.@e@......
w.....e...e@e....e..@e@....e.@e....w
.....e@@e@e@@..e@..@e.ee@e...eee....
..e....e.e@eee@.e..e...e@.ee@e@@e...
w.@e@e.e@@ee@.e@@e.ee...e.@@@e..@e.w
..e.....e@e....ee@e@@e....eee.......