33,36
357
357
1000
....e@e.e@......@e....e@...e@e......
w.e@.e..@ee..e@@e..@e.@eeeeee@...e.w
...ee@.e@.@e..ee@eee.e@e@@@@@e...@..
..e@@e@.e.e...ee@@@e.@ee@eee.@..@e..
w.@ee.e...@e..@.ee..e@eee....e.ee..w
..e.@...e.....e.e..e...@@e@@e..@....
..@.e...@ee@e@e@@e.@...ee@ee...e....
w.e.@e...e@.@..e.e.e.....e@.ee@e...w
..@e.@.e...ee...e@.e.ee.@e@e@.......
...@ee.@..e@.......@.@@@e@.ee@.e....
w.ee...ee@e@e@e...ee.eeee@e@@ee@e..w
..@@ee.....e@e....@e..@e@e.e..@.e@..
..ee@@eee....@.....@e....e.@e.e@.e..
w.....e@@e..@e...e@e.....@.e@.@e...w
......e@e.e.e..e@e@e@e...e..@e@e@e..
.....@ee@e@e..e@@e@ee.......e...e@..
w.ee@e..e@@ee@@@e..e@e......@e.e@..w
..@..e..@ee@.eeee.e@....e.@ee@.@e...
..ee.@e...e@.e@e@.e@e.e@@@eee@e@e...
w..@e@e....e..e@....e@eeeee@@e@....w
..e@ee@..@e@..........ee@.@@eee@ee..
..@e@....e.@e.@e....ee@@e.ee.@@ee@..
w.@e...e...e..e..e..@@e...@e.e.....w
..ee@e@@e..@....e@e.ee@e@e......e...
...@@ee@e@.e...e@@e...ee@e..@e..@e..
w..ee.@e@e.@e..e@e..e.@e.e@ee..e@e.w
..e.e@e...e....@....@..........ee...
..@.@e...e@e@e.e...ee@....e..e@@@e..
w.e...@e.e@@.e@e@e.@ee....@e..ee@..w
..e...ee.eee.e@@e.@e..e@e@@e@..@e...
..@e@e@@.@@...e.e@e@..e@eee.e@e.....
w.@ee..e@eee@...@e.@e..e@@e@e..ee..w
..e......@e.e.e@e..e....e@e...e@@e..