33,36
350
350
1000
..........e@e@ee@ee@e...e........e..
w...e.....@@ee@.ee@@ee..@.e@....e@.w
....@e@...ee....@@eee@..ee.e@e..e@..
.....@e@e@eee...e........@ee@ee@ee..
w...e@ee..e@@e..e@e..e@.ee@@@e@@e..w
......e@@e..@e..e@@e@@e.@e@ee..e@...
..e.....e..@e@...ee@e.e@e@@e.e..e...
w.@e.......e...ee@ee@e...ee.e@.e@..w
......e@ee.....@e@@@.@@e.@ee@.@e....
......@@e@..e@.e@eee.ee@....e.e@....
w.e@eeee.e@..e.......e.e....@ee....w
..e@e@.ee.e....e.e...@.@e....@@.....
..e@e@e@@..ee..@e@...e.e@...@ee.....
w.@@e.e@e@e@@ee....@e@..e@e@ee@....w
..ee.e@e.e@e@@@e...ee@e..e..e@......
...@.e@@e.@eee@@e...e@@e.........e..
w..e..e..ee..ee.@...eee@....e@e..@.w
...@eee.e@@e@@e.eeee@@....ee@e...e..
...e@@@.....e@@.e@@@eee@ee@e@@@e@...
w....ee.e@..@ee...ee@.@.@e..eee@e..w
..e@e@.e.e.e@@@e...e@ee.e@e@........
..e@...@e...ee@.e@......e@ee@e......
w..e@@e.@.....e.@e..e@e...e@.......w
...@ee@.e...e@@.e...e.....e@..e.....
..ee@.e@e..e@ee.@e..@.....ee.e@.....
w.@e....e.e@e.@ee.e@e...e@@e.....e.w
...e.e@.@e@.@e.e@@e@.....e..eee@.@..
..e@.ee.e@.e@@..@eee.e@e...e@@ee@e..
w..ee@e.@e..ee..e.@ee@...e@ee@e..e.w
..e@e@@ee@e...eee........@e..e@.e@..
..e@ee.@e@@eee@@@e..@ee..e.e.@e.....
w.e@e.ee@e@e@@@e.@..ee@..@e@.e@....w
.....e@@e....ee..e@e.....e...e@e....