33,36
361
361
1000
..e@.e..e@ee@e@e@e@e@.e@ee@e@e.ee@..
w..ee@e.e@e@...e@.e.ee@.e.e.@e.@ee.w
..e@e@@e.....e@@e..e.e@e@.@.e.e@e...
..@..e@.ee@...e@eee@..e@e.e.e.......
w.e..@e@@.e......@.@e..e@...@ee....w
.......ee.@e@..e@eee@e.e..@eee@e....
.....@e..e@ee@.e@e@..@e@..e.@e.@e...
w.ee@e....e..e..ee@@e.........@ee..w
..@@e.....@@e.....ee......@ee.e@@e..
..e....e@eee....e@@ee.....ee@e.e@e..
w.@.e@.e@..@e...ee.@@e@e.e@e@@e@.e.w
..ee@e..e.e@e...@..e....e...e..e@@..
...@e..e@.@ee...e@.....e@.ee@@e.ee..
w..e@.e...e@@e...e....e@..@e.e..e@.w
...e@e@...@e@e...@e@e.e@...@...e....
...@e.@ee.e.@e.........e...e@e.@e...
w....eee@.@eee.@e.ee@eeee..ee.e@e..w
.....@.e@e.@.@ee..@e.e@@@e@@@.e@e...
.....e.@e..e.e@...@e.e@e@eeee...@...
w.e@e@..e..e@e@e..e....eeee.@eeee..w
...e.e..@e@ee@.e@e@@e.e@@@@e.e@@e...
..@e.@..e@.....@e@.e..e@ee@e....@e..
w.ee@e..@e..e@ee...@e....e@e.....@.w
..e@@e...e@e@ee@..e@e.......@e..ee..
..e@e....@e.e@e@e...@ee.....e@..@...
w.@ee@e.e@@...e@e....e@.....e@e@e..w
...@.e@..ee....ee@ee@e@e.e@ee@@e....
...e.e@......e.@e@....e..ee@@e...e..
w..e..e.e@e.e@e@.e....@e.@ee@e@..@.w
..e@.e@..e@e..@e...ee@...e.@e@e..e..
..@e@e@...e@..@ee.e@.ee.e@.@ee..e...
w.e...e...e@eee@@....e@.@e.e.@ee@..w
......@e..e@e@e@ee@e@e@e@e..........