33,36
362
362
1000
...e@ee@e@e.e...ee@....e@...e@..e@..
w.e..@eee@..@e..@ee.e...e....ee.@e.w
..@..@e@@ee...e@e@..@ee.......@.....
..e..e..e@@ee@eee@ee.e@e...@e@e.....
w....@e.@eee....@ee@e@@e...eee.....w
.....e@e.e@@e@e.@e@e.@e.....@..e@...
.....@@ee@e@e@eee@.@eee@ee..e...e...
w...eee@e..e.@e@@e.....e@@e@@e@ee@.w
....@@.e@...@e.........@e@eee....e..
...@ee......e..ee@.ee..ee@e.@.......
w..e...ee...@e.@.e.@@e.e@@e.e......w
...e@..@@....eee...ee....e@.@e.e....
..e.e..ee...e@@..eee@..e.ee@@e.@....
w.@@e...e....@ee@@@e@e.@e@@ee..e...w
..ee..ee@ee..e.@eee.@e..e@e@....ee..
..e@@e@@@e@....e@..ee...@ee@e...@@..
w.@eee@ee.....e@@ee@e.....e@....ee.w
.....e..e@ee....ee..@.....ee.@e.@...
..e@.@e@eee@....@@.ee@e..e@e@e..e...
w..e@..e@@e.@e.eeee@e@@..@e.....@..w
....ee...e@.e.e@e@@eeee.ee.....@e@..
..ee@@e......e@e....@..e@@e@e..e.e..
w.@@@ee@ee@....@e...e..e@@e.e...e@.w
..eee@@e..ee.e@e........ee@.@.......
...e@@e..ee@..@e...e@e.....ee.......
w...@e...@e@e.e@e@e.e@.e@ee@@@e....w
....e.e@e@..e.@e@.e@@ee@ee..ee.e....
..ee...@ee.e@ee...@e.e@e@@.e...@e...
w.@@e..e@@ee@@ee@@eeee@..e@@ee...e.w
..ee@..@e@e.e.@.eee@@@e.eeeee@@e@@..
...@ee.e.e..e.e..@e@e...@@e@@ee.ee..
w..e@@.e@@e.@..@eee@....e@.e@e...@.w
.....e..e.@ee..e@.@e.....e.@e....e..