33,36
359
359
1000
...e@ee@e...e.e@e....e@@e.@e@e......
w..@@e@..e@e@@e.......ee.@e..@e....w
...ee.e@.....e..........@e.....eee..
..e@e@ee.@e..e@e.......ee.....e@@@..
w..e@@ee.e...e@ee.e@e..@eeee....ee.w
...e@e@@.e@e.e@@@e......e@@@e@ee@...
....e.@e.e@..@ee.........ee@ee@@e...
w..e@ee..ee..e@.e........@ee@..ee@.w
..e@e...e@...@e.@ee..ee.....@e.@ee..
..@.@e@e.........e@..@@.....e...e...
w.e@.e@e.......e.....ee....e..e.@e.w
...e..@e.....e@@e@e.e@.e@ee@.e@.....
......e....e@@e.e@ee....@ee@ee.ee@..
w.....@..@eee@.e.e@@ee..e.e@e@.@.e.w
..e@e.e@eee@.ee@.@e.@@ee@ee@...eee..
........@e@@e@e..e@.e.eee@ee.ee@@@..
w.......e..ee@@ee@e@e@@@e@@@e@.@ee.w
..e.e.e@@e...e.e@...eeee@eeee@.e@...
..@e@..e@ee@@ee@e..e@@e@@e...e.@ee..
w......e@e.ee@@e..e..e@.e.e@e@eee@.w
...e@...e@ee@@e...@e....e@ee.e@@@e..
....e..eee@..e...e@..e..@e...e@eee..
w...e..@@e@e@..e..e..@@e@e...@e.e@.w
...e@e@e@e..e.e@@ee@eee@.e@e.e..@e..
...e@@e....e..e@e....e@@e@.@e@..e...
w.e.e.e...e@e@e@.e@eee.e@....@e@e..w
..@e@e@.e...e@@e@..e@@e@..e..e@@e...
......@e@@e..e..e.e@.e@e.e@e...e.e..
w....ee@@ee....@ee.e@e@@e@...e..e@.w
.....@..e@@....ee@....ee@e..e@e@e...
...e.e@..ee@e@.e.......e.@e..e@.@...
w.e@..ee@@ee.e.@.....ee@..e..@..e..w
..@e..@ee......e....e@@e..@e@e..@e..