33,36
356
356
1000
....e@e.e@..e.e..eee@e@.e@@e........
w.e..e@.@e..@e@@e@@@e.e@eeee.......w
..@e@e.e....ee@e..ee@.@e..e@.e@.....
.......@e....e@e.e@...e@@e....ee....
w........e..e.......@e..e......@e..w
...e@..ee@..@ee@e.e.e.......e.@e....
....e..@.@e.e@.e@.@e@.e..eee@ee..e..
w.@ee.ee.e..e@e@.....e@@e@@@@e...@.w
..e.@e@@e....eee@eee@..e..eee@e@.e..
..ee@e@@e....e@e@@@.e....e@@e.@e@...
w.@@eeee.e@e.e@eeeee.e@e..e@...ee..w
..e@e@@@...@.e@e..e@e@@e@e.e...@ee..
...e.@ee...e...@e@e...e@.@e@.e@e@@..
w..@.e...e@ee..e@.e@ee@.e@ee@@e..e.w
..ee.....@e@@e@e..@e..e@....e.@ee...
..@@e....@e@e@.@.e@@e.@e@e...ee@@e..
w.ee@...ee.e...e..e@e.e.e....@.e@e.w
..e@..e@@e....e.e..@ee@e@.e.ee@@@e..
..ee...e@e.ee.@e@.ee.e@e@e@.@.eee...
w.@@e@...@e@@e.e@e@e.@@ee.e.e.e@...w
..ee.eee.e.......@e@@ee.e.@e@.......
..@..@@@e@e..e...e.@e...@.ee.@e.....
w.e.@eee@e...@e....e@.@eee@@ee.....w
..e.e.ee@@e@e.@e@e@.e@e@.ee..e@e@...
..@...@eee@@e...e@e.....e@@e.@e.e...
w.e.....@..e..e......e@e@e@ee@@e...w
..e.e@e.ee@e@e@...e..........e......
..@..@e..ee.e@...e@e................
w.e@ee@..@@e@....@ee@e@e@e@.e..@e..w
.........ee@@e..ee@@e@e.e.ee@@eeee..
.......e..e@e.e.@ee..ee...@e.eee@@..
w......@e....e@e@e@..@@e@..@ee@..e.w
.............@e..e@e.ee.ee@e........