33,36
344
344
1000
........e@e@..e@e..@e@e.e@ee...e....
w.e....e@.ee..@ee@ee.e@.e@@@e..@ee.w
..@ee....e@...e@@e@.e@e@eee@e@e..@..
..@e@e@e.@@ee.....e.@e..e@e.....ee..
w.e@e@.@eee.@e....@e...e@@e.....@..w
..e.e..e@@@e@@.e..@e...e@e@e@e..e...
..@.@e..@e@@eee@e.ee...@e.e@@e......
w.ee@@..eee..@e@@e@@@e.....@ee..e@.w
...eee..e@.....e.@.ee@...e@e@@..@e..
...@e....e@....e@e@e....ee@e.e......
w....e..eee.....e......e@..@..e@e..w
.....@.e@@@e....@@e..e@e...e@e..@e..
...e.e..@ee.....ee@.e..e@e.......@..
w..@....e@@e.......e@e.e@..e@...@e.w
...e.......@.....e@@e@eee.eee...e...
...e@e..e@ee..@e..ee.e@@e@@@..e.....
w..e@........ee@..@e.e@@eeee@e@e@e.w
....e......e.@e.......ee.@....e@@e..
.......e.e@@e@e.e....e..@e..e@e.e...
w....e@@..ee@e..@e@e.@e@e@..e@@.@e.w
.....@ee..e@.@.....@e@e@eee@eeee@e..
...e@@e...@e.e....@e@..e@@e....e@@..
w...ee....ee..e@e.e.....e@@e...eee.w
....e@.@e.@@e..ee@ee..e@@ee@..e@....
..@e...ee@e@e..@e..@e..e.e@@e@......
w.e......e.e@.@e...e@e@....e@eee@..w
..e.@ee.e@@ee@ee@..@e@eee@e@..@@e...
..@ee@@e.ee.@e..ee.@e.@@ee@...e.....
w.@eee@e.@ee@e...@ee..ee@@@e..@....w
..e.@ee@.e@e@e...e@.@e.e@ee...e.e...
...e@@e@.@@e@eee.e@ee.e..e@....e@...
w...ee.e.ee..@@@.....e@..@e....e@e.w
.....@e@e@...eee.....e@ee@e.........