33,36
353
353
1000
..@e@e.e@....e.e.@ee....ee.....e@...
w.e..@..e....@.@ee@@ee.e@@.....@e..w
..@e.e....e@@ee@@ee@e@@e.eee.@e.@...
......e@eeeee..e.@ee@.e..e@@ee@.e...
w......e@@@@ee.e@e@..e.e@e@.....e@.w
..@e.....ee@e@...e@ee@....e.e@...e..
..e....e@e.@eee.e@@e.@e......e..e...
w..e@@e@@e.e@@@e@.e..ee.........@e.w
....ee@.ee@@ee@e....e@@.............
....@e.e@@ee@..e......ee....e@e.e@..
w...e@@e..e@.ee@e.....e@e@e@e@...e.w
.....@e..eeee@@e@....ee@e....ee@e@..
.....e@.e@@@e.eee...e@..@e.e@e@@e@..
w.........e@@.e@@..e@@e.e@.e@@ee.e.w
.....e@ee@eee..@ee...ee@@..@e.@..e..
..e..e@e..@.@e.e.@e@e@.ee..@e.ee.@..
w.@.e@e@.@e.e@@e.e...ee@.@ee.e@@.e.w
..e.e@ee@e....ee@e@e..e@.e.e@@eee@..
......e@e...e@@.e...@e.e...@e...e@..
w..e@e.e@e@e.ee.e@e@e.....e@e.@e.e.w
....e.@ee@@e@e.e..@e.....ee@e@ee@e..
..ee@.e..eee@ee@....e@e.e@@e..@e....
w.@e@...e@@.@ee@e@e..e.ee@..e..@e..w
..e@e...e@eee.....e.e@.@ee..@.......
..e@@...@@e@......@.@e.@e@..e@e.@e..
w..ee..@ee.......ee.e@.e@.......e@.w
...e@..e..@e.e...@e@.e.e@e.e.@e.....
..........e..@....@ee@.e@..@.ee@.e..
w...e@e......e...@e..e@@ee@e.e.e.@.w
..@e...ee....e@e.e.e.ee..ee@e@ee.e..
..e.@ee@@ee.......e@e@..e@@e@@e@@e..
w.e.e..e@@@e...e@.@e@...e@e..e@.e..w
..@e....ee@e....e..e@e.......e@e@...