33,36
352
352
1000
..e..e@e@e..e@e.ee@e@e.e@.e@e@e@@e..
w.@.e@@e@@.....e@...e.e.e.@e.e.eee.w
..e...e.ee@.e@e@@e.e@e@.@e.......@..
......e...e@e...e...ee@...e@e.e@ee..
w....e@..e@.........@@e@....@e@....w
.....@e@.e@e..e.e@@eee.e...e@e......
.....e.ee@....@..ee..@e.e@e@e@......
w.e@.@.@@e....e@e@@e.e@e.@e..@e@e..w
...e.e@e........e@e@.@.@.e.e@e@..e..
..e.e@..ee.e....@e...e@e..e.....e@..
w.@ee@e.@@.@e........e@@e@@e.@e@ee.w
.....e@@eee@ee@e@e...@e..ee@.e@ee@..
..e..@@e..e@e..ee@eee..e@e@.e@e.....
w.@..ee...e@@e@@..@@@e.@e@..ee@....w
..e..@e@e.@ee.ee..ee@.e@.eee@@e@....
......e@e@..@e@@....e..ee@@e@e.e....
w....e@e.e..e@.e.e@@e.e@e@e..@.....w
...e.@e@.@@e.....@ee....e@@e.e......
..e@e@e..eee......@.@e..ee.e...e@e..
w.ee.@e@e..@e.....e.e..e@e.@e...e@.w
..@@.ee@ee@@e.e.....ee..e@e@ee......
..ee.....@eee.@.e@ee@@e@.....@e@....
w....e@e@.@.@ee..e@@e..e...e...e...w
...e..e.e@e.........e..e..e@...@e...
..e@..@e.ee....e....@@e@..e@e...e...
w..e@..@e@@e.ee@.@e@eee....e@..e@e.w
....e@.e.e@.e@...e.e..@e....ee.e@@..
....@ee@@ee.e@.e..e@.ee@e@e@@@..ee..
w.eee.e@e....e.@.....@e@.e@eeee@e..w
..@@@e....e@...e.e...e.e.....ee@e...
..ee...e@e.e@....@eee@e@.e..e@e@....
w.e@@e.@.@e.e..e.@e@@.@e@@e@ee.e.e.w
....e@.ee@e....@eee@e.e.eee@e@..e@..