33,36
347
347
1000
..@e..e.....ee@e.e@e...e@e.e.e@eee..
w.e..e@e...e@@e.e@@e.e@@ee@@....@@.w
....e@...........@e...e@eeee.@e.ee..
....e@.@e@.e@e...e..e...@@e@.e......
w.e@@e.e.e@e@.......@e..e@@e.@e..e.w
..@e.@e..@e.e.e..........e@e.e@..@..
...@.e@...@e..@e@e..........e@e@.e..
w..e.@ee.e...ee.......ee@e.....e...w
......e@.@e.e@@...e@.e@.......@e@e..
.....e@ee@e.e@e...@ee@e.e...e@e.....
w...e@@e....@.@e@e.e@@ee@..e..e@...w
......ee@e@ee@@e....@e..@e.@e..e....
....e@ee@e.@.ee..ee.e.e@e@e@.e@e.e..
w.e@.@ee@e.ee@...@@e@..@e.@e..e@e@.w
..@e.e@...e@@....e@e@e.e..e@....@e..
........ee.ee......e@e...e@e...e@...
w......e@@e@.@ee@....e@..ee@....e..w
.......e.....e..e.....ee@@@e.....e..
...ee..@e@e.e.e@@ee.e@..ee..e@@ee@..
w.e@@e@.e@@e@.@e@@@@ee@......ee.e@.w
....e@e@ee.e@...eeee@.e....e.e@..e..
...e@..e@...e..e.@e.e@@e.e.@eee.e...
w...eee@e@e..e@@ee...ee@.@ee@@@e@e.w
...e@@@@e.e.e@ee@@.e.....@e@.ee.e@..
..e..eee@e@.@e.e@ee@e@e..e@@e@@e@...
w.@@e@.e...e@e.@e...e@e.e@.e.ee....w
..ee.ee@....@ee@e...........e@......
...e@@e@eeeee@..@.@e....e.e@e@e.@e..
w...e@e..@@@e...e.e@..ee@e@.ee@@e@.w
...e.@e..eee@.....@eee@@@e..@@ee....
..e@.ee...e@......@e@e@eee@.ee@@e...
w..e@@@e....e.e@..e.....@eee@.e@...w
...@ee.....e@..e.....e@e.@ee@e.e....