33,36
367
367
1000
..@e..ee.e@.@e....e@e@...e@@e.......
w.e...@@..e@e...e@e@ee..e.ee.ee..e.w
..e...ee@e.@e...e@ee.e..@...e@@.e@..
..@e..ee.e@eeeee@e.@.@e@e.....ee@e..
w....e@@.e@e@@@@e..e.e..e.e@ee@e@e.w
.....e@e..e@@ee.e@e@e@@e@..@ee@e....
.......@e@..eee@e..e.@e.@e.e.e@@@e..
w.@e...e@e...@e@eee@.e..e@@e.eeeee.w
..ee@.e@@ee@e@e@e@@e.@.e@.e.e@@e@@..
..e@e.@ee....e@e@e...e.@e...e.e..e..
w.@e..e@@e..e@ee.@.....@ee.e@.@.e@.w
..@e..@e@e....@@ee.....ee@.@e.e@e...
..e.e.e.ee@.eeeee@e.e...@e..........
w..e@.ee@@ee@@e@@e@e@e.e@eee.....e.w
..e@@e@...e@.e@.ee@@....e@@@e.e.e@..
....e.e..ee..e..e.ee....eee...@e.e..
w.....@e.@@..@ee@e@.ee.e@@e....ee@.w
.....e@e.ee.......@e@@e.e@.ee@.@e...
.....@e..@@e......ee@e.e.ee@.ee.....
w........e........@.e@.@..e@e.@e.e.w
......e@.......@e.e....ee......@e@..
..e...@e.......e..e@e@e.@e...@ee@...
w.@.e@@e@e@e@ee@....e.ee@...ee.....w
..e..ee@@e.@e@@@e...@e@ee..e@ee@ee..
..@e@ee.e@.ee@ee...e.e@@@eee@@.ee@..
w.e..e@...e.@e.....@eeeee@@eee.@e..w
..@......e@e.e@..ee@e@@e.....ee..e..
..e....e@@@e.@e.e@..e@e.ee@ee@@ee@..
w......eeee@...e.@e@e@e@@.e@...e@..w
.......@e@.....@.ee..@eeee@.ee......
......@e@e...@eee@@e.ee.....@@e.e@..
w..e@.e.e@e..e@ee@e..@@e....ee...e.w
...@e.....@e..e@@e...e.......@e.....