33,36
346
346
1000
..e@e@...e....@e..@ee..e.......e....
w....e...@eee@e.e@e.@e@@e@.e...@...w
.......e@e@@@e@.@e@e@ee..e@@...e....
.......e@..e.......@@e....ee....ee..
w.@e.e..e.........eeee..@e.....e@@.w
..e..@e.e@......@e@@@@..e@..e....e..
..ee@@e.@e...e@ee..eee@.....@.......
w.@eee@.@e...ee@@@e@..e.....e...@e.w
...@ee@@e@...@.eee@....e@e...e@ee...
.....@ee.e@e@e.@ee.e...@e.......e...
w.e@ee..e@ee@e..@@e@e......ee@..@e.w
...e@@e.e@@.e@..ee@@e@e....@eee@@e..
....e@e..ee@@e.....ee@@..ee..@.ee...
w..e@e@ee..ee@@e@e.@eeeee@@e.e.....w
...@.e@@@e..@.e..@e@e..@.e@..e......
...eeeee@.e.ee..ee...e@e@.e@.@e@.e..
w.e@@@..e.@.e@..@...e@@ee..e.e@e.@.w
..@@ee....e.e@eee@ee..e.@ee..@@e.e..
..ee..e.@e..@e@@.e@@ee@e.e@eeee.@e..
w.@ee@@ee@.e@..ee@@e@e.@e@.e@...e@.w
..@e.e@@e..@ee.@..e.e@e@.@e.@e@e@...
..e@..ee@@e..@eee.@e...e@e..e..e....
w...@e.@@e.@e@@e@..@e@e.e@.@e..@@e.w
....e..ee..e@e@e..e@@...@@ee@..ee...
....ee@@e.....e@.e.ee..eee.....e@...
w..e@ee...@e.....@e...e@@..e@......w
...e@@e@..e.....e@@e.e@@e...e.......
....e.@e@ee...e..e...e.e@.e.e..e....
w.......e@@...@e..@ee@.@.e@.@e.@e..w
..........eee.....e....ee@ee@@e@....
.........ee@@e...e...@e.@e.ee..e....
w.e@e@@ee@e@eee.e@e..e.ee@e@e@..e..w
...e.ee..e@.e@@e..@e..e@.e@..e.e@e..