33,36
364
364
1000
..e.@ee@...@e@@e....e...e@@e....e@..
w.@ee..ee@ee.ee.e@.e@e@e@eee...@ee.w
..e@@e@e...e@e@.@ee@.....e.@e..e@...
..e@...@.e@ee..e@.e@e...e@.@e...@e..
w.ee..ee.e@e..e.ee@...ee@e@e....ee.w
..@ee@@..ee@e.@e@..e..@@e.e@...ee@..
..e@@eeee@@.......e@e@e...@@e@.@e@..
w..@e..@@.e.e@......e.@..@ee@e@eee.w
...e..eee.@@ee@e....@ee..e@e@.e.@@..
...@e.@e..ee@e@e..e.......e.e.@eee..
w.e.e@e@ee.......e@..e@e@e@e.....@.w
..@e.e..@@.......@ee...@@e.@e....e..
..e@....ee...e@e.e@@ee.ee@.....e@e..
w.e@@e@@e@.e@.e...@e@@e@...ee@ee@e.w
...ee.ee....ee@...ee@eee.@e@e..e@e..
.......e....e@..e..@ee@@@ee@@eee@e..
w.....e@e@..e@e.@..e@e@ee@.e.e@....w
...e..e@@e...@e.e.eeee@....@ee@e....
..e@..@ee@.e.ee..e@@@ee@..e@@.......
w...e@...ee@.e@.e@.ee..e...ee......w
.....e...@e@ee....e.@e........eee...
...e....e.e.e@...e@@e@.......e@@@e..
w.e@....@e@...e..e.e.e@e..e....e@e.w
..@e.eeee@...e@e@@.......e@......@..
....e@@@@e..e@@eee..eee@e.e@ee..@e..
w....eee......e.e@..@@@...e@e@..e..w
....e@..e.........eeeee@....@.e.e@..
..e.e@@e@.e@......@@e@.e.e@ee.@.@e..
w.@e@ee@..@e...ee.e....@.e@e.@e.ee.w
..e@@ee@e.e...e@@e..e@.e.@e..ee.@@..
....e.@.e.@e.e.....eee..e@e.@e@.ee..
w.e..ee@@e@e.@e...e@@e.e.ee.e@e..@.w
..@e.@ee..e@e@e@e..e@ee@e@@e.e@..e..