33,36
364
364
1000
.....ee@ee@e@e@e@eee@@e...@ee@e@e...
w.e@e@....e.e.....@.ee@...e.eee@.e.w
..@e.....e........e..@e....e@@@ee@..
..@e.....@e.........e@e...e@ee......
w.e......@e....e@e.....@e@@e@e.e...w
..@e.e@.@e.@e......e.e@eee..e@.@e...
....@ee.e@ee..e@e..@e@@e@@e.@ee@@...
w...e.@...@.e.e@e@e@..e@e@...@eee..w
.....@e...e@@e.e@e.ee@ee.e.ee..e@e..
..ee@e.....e..e.....eee@..e@@e..e@..
w.@e@@e.e..e@e@@e..e@@e.e.e@e@..@..w
..eee...@..ee@@e.e.@.@e.@e.e.e.ee...
..@@e...ee.@e@e.e@.e.e....@e.@e@e@..
w.e......@ee@..e@e..e@e@e.e@eee@.e.w
........e..@ee@@e@..e@e..ee@@@@ee...
....e@ee@.....e@e@.......@@eeee@@...
w...@@ee@ee@..e@.e..e..e.ee@e...e..w
....ee...@.e...e@@e.@ee@.e@.e@.e....
..@ee....e..e...ee..e@e@.e@..ee@e...
w.e.@e...ee@@e@.......eee.e...@e...w
...e@...e@eee.ee.e....@@@e@..e@e@...
...@e...@@ee@e.@.@e...ee...e@e@.e...
w.e@....ee..e@.e..@...@e@e@e@eee...w
...e@ee@e@........e..ee@e....e@@e...
..e@..e@e.e@......e.e@e@@e..........
w.@e..e@e@.ee....e@e@@ee......e@...w
..e....e@ee@@e..e@e..e.e..e@e@.e....
..@e....e@.e.....e@.e.e@.ee@@eee....
w.@ee@e.ee.@.@e..@@e@e@ee@@ee@@@...w
..e..@e.@@ee.e...ee.e@e@e..e@.eee...
.....e.ee@.e@e...@e.e@ee@ee@e..@@e..
w.@e.@e@ee.@.@@e@@e@e.ee.@@e@..ee@.w
..e.e@ee@..e.ee@ee...e@@ee.......e..