33,36
360
360
1000
.....e@e...e@ee.e@e.e@...e....e@e...
w..eee@e.@ee@.@.e@e.@e...@@e.e@e...w
...@@@eeeee.e.e..@e......ee@.@e.ee..
...ee@.@@.@ee@@.@e..e@e....e..e.@@..
w....eeeee@..eeee........@e@.e@eee.w
..e.ee@...e....@.e....e@.ee@e.e@....
..@e@e....e@e..ee@....@ee@@e.e@ee...
w..e@@...e@e..e@.@ee@..e......e@@e.w
....ee...e@@..e@@ee.e@.@e..e@ee@....
.......e.@ee@e.eee@@eeee@e...@@e....
w...e..@..........@ee.@@e@e..e..e..w
..e.@e.e..........e@@ee..e@.e..e@e..
..@......e...ee..e@....e.@e@@@e@.@..
w.e.@e...@e.e@@e......e@e@eeee...e.w
..@.ee..e@e@e@@e@ee@..@@e..e@..e@e..
..e.e@..@.@e.eee@e@e..ee.e@e@.@e@...
w.e.....e......e@e@e.....e@@e.e.e..w
..@e@ee.@ee@...@e..@e@.ee@e@@e..@e..
..e@@e@....e..e@e.@e.ee@@e.e.@e..@..
w.e.e@...e.@e@e@e.eee@.@e@..e@e@ee.w
..@ee@...@ee@..e..e@@e@ee@..@e..e@..
..@e.e..e@@e.e@@@ee@e....eee@e.e....
w.e.e@@e.e....eeee.ee@ee@@@e@e.@...w
...e@ee....@e@@ee@e@..@eee.e@@ee@...
....e@@e...e.e@..@e@@e@e....e...e...
w..........e@eee.e.ee@e@.........e.w
...e..........@@e@@e@.e..ee@...@e@..
...@e.e@.e@e..e@eee.ee@.e@@e.e@e@e..
w..e@@ee.e......e@ee@.@e......e....w
..e@.e.e@@.....e..@.e@e.e....e@.....
.....e@@ee..e..@..e.@...@......e@e..
w.e.eeeee.e.@e.e....ee.ee@e...e....w
..@e@@e@@e@..@e.....e@.@e....e@e@e..