33,36
357
357
1000
...e@..e@e.....e@e...@e.e.e@...e@e..
w..ee..@e@......e@e..e@.@..e.e@@...w
...@e....e@.....@e.e@@e@e@e@..ee....
..e@e..@e@e.....e@..e@e.....e.e.....
w.@e@..e@@ee..e@e....e...e@e@e@....w
..e..e@@.ee@e@e@@e..e@.e@e...@...e..
..@e.eee....@e.e.@e..e@e.@...e...@..
w.e.e@ee@e@ee...e@e...ee.eee@.e..e.w
..@e@@e..e@e@.....e@.e@@.e@.ee@.....
..e@@e......@e.....ee@ee@@e@..@e....
w...e..e@e@.e.@e....@e..ee.e..ee...w
......eee.e.e.e....e@e.e@....e@@e@..
......@@e@ee@.e@e.e@@ee@.........e..
w.e@..e@ee@e@.e@e@..e.@@e...@e...e.w
..@e....@@..e..eee....ee@.e.e@...@..
...ee...ee....e@@@e...e@e.@ee.ee@e..
w.e@@e...@.ee@eee@......@..e@.@@...w
..e@e@..@ee@@.@@eee..e..e.e@e.ee@e..
...e....ee@.e.e@ee@e@@...ee@@.e.....
w..e@.ee@@e@e.e..e@eeeee@@eee.@e.e.w
....e.@e.e....@ee@ee..@@e@e.....e@..
..e.............e@@@eee...@e.....e..
w.@e@..e@e....eeeee.e@e..e@@@e.ee@.w
..e.e........e@@@e..e@@e.@eee@e@....
..@@e...@e@ee..e.e@e@e.....e..@@e@..
w.eee.@eee..@..@e..e@e...e@@e.ee.e.w
...e@ee@.@e.ee....e@e@ee@.e@e...e@..
..e@@e.e@..e@@e@e@@ee@@@e...........
w.@eeee.ee@e@e..ee@..ee.....e@@e...w
...@@@@e@@@e.@..@.e...@e...e.ee.....
..eeee.@eee.@e.@e..e....@e@@ee@..e..
w.@@...e....e@.ee@e@@e..eee@..e.e@.w
..ee...@e.......@ee@e....@ee..@e....