33,36
356
356
1000
......e@e@..e@ee.....e@.e@e..e......
w......e.e...e@@e.e..@ee@@e..@e@e..w
......e.....e@@e.e@.....@ee@.e@e@...
..@e..@.@e@e..e....@e.e@e..e........
w.e.e@e.e..e@@e.e..e@...e..........w
......e.@...ee.e@e@@ee.e@.e@ee...e..
...@ee@@e.........e..@e.e@eee@...@..
w..e.@ee@.e@........ee@@ee@@e....e.w
...@e...e..ee....e.e@e.e@.e@@e@e....
..e@e...@e..@e...@e@@e....@ee.ee.e..
w...e@e...@e@....e..ee@e.e.@e@@@e@.w
..eee@e...e.e............@e@eee@e@..
..@@e@.@e...@@ee@e.....e..e@@@@e.e..
w.eeee.ee@..ee.@e......@e..eee..e@.w
..e.@@e@.e@.@e...@e@.ee@e...e@......
..@.e.@e.ee.e@..@eeee@e.........e@..
w.e..e.e@@eee@e.e@@e.e@e.....e@..e.w
..@e.@..e..@e@..ee@e@e@@e@e..@eee...
..@e@e@e.ee@.e@e@e@e@ee.ee@@e..@@e..
w.e.e.e@e@.e..e@..@e...e@..e.@eee@.w
..e.@e@....e@.e@e.e....@e....e.ee@..
..@e@.......ee@..@e...e@.e..@e@@ee..
w.e.e.e@.....e@..e@e@.@e@@e.eee@...w
...e...e@....@e..e@@e...e....@@ee@..
..e@....e.........e@e...e@e@ee...e..
w.@@ee@e...e@@e@e...e@ee...e.e@....w
..ee@e@@ee.@ee@.@e@.e@.@e@e@..e.ee..
....eee..@e.@e.e@.e..e..@e....ee@@..
w...@@e.e@ee@.e@e......e@e.e..@@ee.w
....ee@.e@.ee.@e.@e@e@..@e.@@ee@e@..
..e..@..ee.@@.e@.e@e@ee.e..ee.e@....
w.@e.eee@@eee.@.e.ee@@@e..e.e..e...w
..e..e@e@e....ee@e@.eee@..@e@.......