33,36
345
345
1000
....e@@e@e.ee...ee@ee@e...e@ee@@e...
w...@eee.ee@@e..@e..@e@....e@.ee...w
....e@e@e@ee@@e@e@e...@e.....ee@e...
....e@@e@...e@e..e@...e.e@.@e@@e....
w....eee@e@e@e@e.e@e..@e.e@e.......w
.....ee..@e...e@....@ee@e..@..e.....
...ee@@e.e........eeee@.@..e.e@.....
w..@e@@e.@e@...@ee@@ee@ee.e@.@e....w
...e.ee@e..e...eee@e....e@..........
...@e.@e@..e@e@.@e@@e@e.@e...e...e..
w..e@......@e.e.e@e..e@.....e@...@.w
...@eee@e................e.e@..e@e..
....e@...e......e@e@.e@e.@e.....e...
w.e.e@e@e@@e@e@e...e.@@ee@e.e@e.@..w
..@e...e@@eee....ee@eeee@ee.@e..e...
......e..e@@@..e@@@e@ee@.e@..e@e.e..
w...e@@e.e@ee.e.ee...@.e..ee.@e.e@.w
..e@eee@...@..@e.e..eee@ee@@..e@@e..
..e@ee@@ee@e.e..e@@e@@ee@..e@.@e....
w.@e@e@e.@.@e@....e@.......@e......w
..ee..e..e..@@e...@..e@.@e.@ee@e....
..@@ee......eeee..e..ee.ee.e.e......
w.ee@@..e....e@@e@e.e@@e@@.@e@..e..w
...e.e.e@@e...e....e@.e@@ee..e@e@...
...@e@...e..@e@...@e@.e@e.@..e@.....
w..ee@.e@.eee.@ee@e.e.@e.@e...e.ee.w
...@.e@.ee@@@.e.@.@e@..@.e@....e@@..
..ee.@e...@ee.e.e.e....e..e@e....e..
w.@ee..e..e...@e..@e....e@e........w
..e@@ee@..@@e...........e@@ee@e@e...
...e@....eee.e@e........@ee@@@ee@...
w..@e..ee@@e@....e@..e..e.e@ee...e.w
......e@..e@e.....e..@ee@..e@@e.e@..