33,36
367
367
1000
....@e..e......@e...e@e@@e.@e.e@e...
w...ee..@e.e@e.e....e@eee..e..e@@e.w
...e@@e.e@.e@e.@..@e@e..e.ee@.@e@e..
..e.@e.e@e.e@e@e..ee....@e@.ee@e.e..
w.@ee..@@e@e@..@e@e@.....e@ee@e.e@.w
..@e...ee...ee@e.e@.....@e@@e@@e....
..e....@@....@e@......e@e.e.@e.e@e..
w..e@e.ee.e@.e...........e@..e@@e..w
..e@@ee@e@ee....e@e....e...e..e..e..
....ee@ee.e..e@...@....@.e@@e...e@..
w...e@e@@e@...e...e....e.@ee..e.e@.w
.....@e@ee@.....@e@.ee.....@ee@.@e..
..e@ee.e@ee.e@@ee..e@@e.......e.....
w.@.e@...@e..eee@e@ee.e@e...e.@e@e.w
..ee@e....e.e@@@e@e.@@e.@e..@ee@e...
...@...@ee@e@.e.ee@.ee@e.....e@e@e..
w..e...e......@e@e..e.e@...e@.ee@@.w
..@e@@e...ee@ee@.@@e@....e..ee@.ee..
..e.ee..e@@e..@e.ee...e@e@ee@ee.....
w.....e@eee@..e@..e...@@ee@@ee@e@..w
......@...e@eee@ee@..@ee@..@ee@ee...
.....ee..e@ee@@@e....ee@e@.e..@ee...
w.e.e@@e...@@eeee@...@.@ee....ee@e.w
..@ee@e.e..e....@e...eee.@e...@e@@..
..@e.e.e@...e..e@ee@.@@.e@e.e.e.ee..
w.e..@....e.@e.@e@.e.ee@ee@e@......w
.....e...e@e@eee.....@@e.e.@....ee..
..@e....e@...e@@e.e@.ee@e@.e@..e@@..
w.e.....@ee@@ee@e..ee@@ee..@e....e.w
.......e@e.ee...@.eee.e@@.e@e.......
.....e@@@e....e@ee@@@e@.e..e.e@@e...
w.....eee.ee.....eeeee.....@@eeee..w
.....e@..e@@e...e@@e@@e....ee@.e@e..