33,36
355
355
1000
....e@e.ee@@e.e..e.e@..e@e@ee....e..
w..@e..e@.eee@@ee@@ee..@ee@@@ee@e@.w
...e@..@@e...e@.eee.e@e@e.ee.@.@e@..
..ee@e@ee....@ee@@@e.e@@e..@ee@e.e..
w.@e.e....e@.....e.....ee@ee@....e.w
..@ee@..e@@ee..e@@...e...e.e@@e.e@..
..e.e@e..e@.@e@eee..e@..e@..ee@ee@..
w.@e......e.e@.@e.e...ee@e...e@@ee.w
..ee..e...eee....e@...@@e....@e.e@..
..@@ee@..e@@@e..e.e...e.@e......e@..
w.ee.e@e...ee...@.@@e@e@e@.....e.e.w
...@ee@.e...@...e@eee@.ee@ee@e.@e@..
....e@e.@ee.e...e@e@.e.@e@@e..e@e...
w.e@@.....@.e@e@.e@..e@e.e@.e@@e.e.w
...ee.....e.ee@e.e@e.....@e..e.@e@..
..eee@e..e@e@.....@e.e...ee....@e...
w.@@e@....e@@e..e@e..@e@.@@e@..e...w
..ee@e...e@.e...e@@@e.@e@e..e...e@..
..e@...e..e@ee..@eee..e..@e@@e...e..
w.ee...@e....@e@ee@@..@@e..e..e..@.w
..@@@e.......e@..@.e..ee@.e...@..e..
..eeee.e@e.e@@@e@e...e@.e@@e.ee.e@..
w..@@@@e@@e.eee..@e......e@..@e.e..w
...eeeeeeeee.....e..e@....e@.@e.@e..
..@e.e.@@@@@e....@e.@e....@e.ee@....
w.e..@eeeee........e@e....@e...e...w
..e...@e@...e......@@e@e..e...e..e..
..@ee..eeeee@.e.@e.eee@e..e..e@.e@..
w.e@@@e@@@@..e@.e....e@@..@..e@ee@.w
..e@eee@eee.....@@e...ee..e..@e..e..
..e...@e@..e.e..ee@.......@ee.......
w.@e......e@.@...e.e....e@@e@......w
........e@ee@e..e@.@e....ee@........