33,36
362
362
1000
..e@e@e@ee@eee@...@ee@@ee.e@@e.e@...
w...ee.@ee@@@ee...e..eee@e.ee...ee.w
...e@@.e..ee.e.......@@e@@eee.@e.@..
..e..ee...e..@e@...e.e.eee@@@.e.ee..
w.@ee@@...@e...e...@@e.@@e.ee..e@..w
..@e.@e..e@e@e@ee@.ee@.e@ee@........
..e@.e@....@ee@..ee.e@e@..e..ee@....
w...e@e@e.....e...@.@.....@.e@@e...w
...e@@e@ee@e......eee.....e.e@e.@e..
..ee@e....@e...ee.e@@........e@.e...
w.@e@e.ee@e.e@e@@.@@e..@e.ee@e.....w
......e@@e@ee@@@e.ee.e.e@.@e..e@e...
......e@e..@eeee@e@.e@........@.....
w....@ee@.e@@.....@ee@..e@e...e.e@.w
.....e.@@e.eeee@e.ee.e@e@@e...@..e..
..e..e@ee..ee@@ee@e@.@@e.e....e.....
w.@ee@e....@ee@e@e@..ee..e@.e..e@e.w
..ee@@e.e@..e.e@.....e....ee@eee....
..@e@e...e@e@....e@ee@@e..ee@@@@....
w......e@@@e@e.e...@e@e@..@eeeeee@.w
..e..e..eee..@.@@ee@e@.@e..e@e@.@e..
..@..@e.e@@e.e.eee@@ee.e...@e.......
w.e@e@e@ee@e..e.@..ee......@e.@e...w
...e@e..e@...e@.e...@e.e@e@e..ee@e..
...e@@...@e..e@e@@ee.........e...e..
w..eee...ee...@eeee@.....e...@e.e@.w
..e@....e.@...e.@@@@e...e@..e.@e....
...@e...@ee.e...eeee..eeee.e@e@.....
w..e.@ee@e@.@e..@@e...@@@@ee@eee@e.w
....@e.e@@.e@ee.e@e...eee@e.e.@.e...
....ee@.ee@e..@ee....e@e...e@.e@@e..
w.....e..@e...e.@e...e@@e@....@e@e.w
.........e@...@e......e..e......e@..