33,36
359
359
1000
...e...e@...e@e@e.e@.e@@e........e..
w..@...@e@.e.@e.e..e@eee..e.....e@.w
...ee....e@@eeee@........e@...e.e@..
....@e..e.e@.@@@@e.....e@e....@e@e..
w....@e@@.@e@eeee....eee@.....ee@e.w
..e.e@.eeee.........e@@ee...e@@@e...
..@e.e.@.@@e@e@e@e..e@@ee.e..eeee...
w.@e@e.eee@.e.@ee....ee@@.@...e@@e.w
..e@@ee@@ee.@eee@...e@..eee@e.......
....e.e@@e.e@ee..e@..@ee@@e....e....
w..e...ee.ee..@...e..e..e@.e@.e@e@.w
..e@@e...e@@e@e....ee.e@@e..eee..e..
..@ee......ee@e@.ee@@.ee....e@@.....
w.e.@.....e@...ee@@.e.@e.@eee@e.@e.w
..@.e...@e@e......e.e..@.e.@@eeee@..
..e....ee@@e.ee..@e.@e.e...e@e@@e...
w..@e.e@@ee.e@@e.e......e@e.ee..@..w
...e..e@@e@e@@e@...@e..e...e@@@eee..
....e.eee.@e.e.....e@..@e.e@@ee.e@..
w..e@e@@..e.e......@@e....@ee......w
.....@@e@.@.@......eee@....e@....e..
...e@ee.e.e.e.e......@e@........e@..
w...e@....@e.e@e@..e...e@e..@e.....w
..e..e@e@e..e@.@e.e@e....@.@ee......
..@ee@.e@..ee@e@e@@e...e@e.ee@@ee@..
w...e@..e.e@@e.e@e@e..e....@eee..e.w
....ee..e@...@e@@e...e@ee.e.e@@e@@..
....@e@e.e@e.@eee@@ee@e@@e@.@@e@ee..
w.e@@e@e...e@e.@e.e@e@e....eee.....w
...ee.@e............e@@e..e@@@..e...
..e.@ee........e..e..e@e..eeee.e@...
w.@@ee.e@e..e@e@.e@..e@..e@@@..@ee.w
..eee@...@e..ee@ee@e.@e..@eee.e@e@..