33,36
344
344
1000
..e@e@e.....e@e@@ee......e...e@.e@..
w......e@e.....ee@@e..e.e@@e.@e..e.w
..e@e........ee@.....e@@e.e@e@e.e@..
....@e@.....e@@e.....e.e@....e@e@...
w.@e.ee@e...e@@e.....@e@....e@@e.e.w
..e@e@e......ee@.....e..e@e.e@e..@..
...e@e..e@....@e@e...@e@.e..ee@@ee..
w...e@..ee@.e.ee@e.....ee@e.@@@e...w
..e@@e.e@@e@@ee.e...e.e@@@e@eee@@e..
...e..e@@e.ee@@e@...@e.@ee..e@..e...
w....e@ee@.@e@ee.......ee@.......e.w
.....ee@e@e...e@@e@e..e@.ee@e@e@e@..
..eee@@ee@e@e@e@e...ee@.e@@e...e@e..
w.@@@ee@e.@e@e@....e@@e.@e.e.e@@ee.w
..ee..ee@eee@e.....e@e@...e@..e@e@..
......@@ee@@@e@e....e..........e....
w.@e..e..@@ee@....e.......e@@e.@e..w
..e..e.e@ee.e@e.e.@..e@e..@ee.......
..@.e@e.....e@..@ee....@e...e@@e....
w.e@ee@.....ee......@e.......ee....w
..e@@.e..e.e@@e..e@ee@.ee..e..e.e@..
...eee@e@@e.e@....@e..e@@ee@.e@..e..
w.e@....e.e@ee....e@@ee@@e@e@......w
..@ee@.ee.@e@...e.@.ee.ee...ee@e@...
..e@.e.@@...e.e.@.e..@e....e@..ee...
w......ee..e@e@.e..ee......e@ee@e@.w
...........e@@@e@..@@e@..........e..
...........@eee@ee@ee.e...e......@..
w.e@e@eee..e@@e.@e..e.e@e.@e.....e.w
..@e.e@@@...e@@ee@e.@e@...e@.@e@e@..
..e@e@@eee...e..@...ee.......e..e@..
w..@e@e.e@...@e.eee..@....e..ee@@e.w
...e....@e..e@e.e@@e.e@e..@ee@.e....