33,36
364
364
1000
.....e...e@@ee@ee@e.........e@@ee@..
w...e@e..eee.e@e.............ee.@e.w
...e@e.ee@...e@ee.ee.e@e@.e..e@.....
..@ee@e@e@e..e@.@e@@..e.ee@..@e..e..
w.e.@...e@e...e....e.e.e@e...e@.e@.w
...ee...ee@..........@e.e@...@@e@...
..e@e@e@@e@e.eee..e.......@e.ee@....
w.e@@e.ee..@.@@@ee@.......e..@e....w
..ee.@e.@e.e.ee@e.e.e@.ee@e...ee@e..
..@e..ee@@e....e@e@..ee@e.ee..@@e@..
w.@e..@.e@@@e.....e@..@e.e@@e.ee...w
..e...e..eee......@e.e@e@@ee@..@e...
...e@ee....@.@e..e@..@e.e@e...e@e...
w..@..@ee@ee.e@...e@e...eee@ee.e@..w
...ee@.e....e@@e......e.@@e@e@e@....
..e.@e.@e@e...e.e@..ee@@ee@.e@e.....
w.@..e.e.........e.e@@eee@eee@ee@e.w
..ee@@e....e@@e.e..@e@@...@@@e.e....
..@ee@e@e..eee..@e.e.eeeeeee.@e@....
w...@e@.@e.@.e@..@.@.@e@@@e@e@e@...w
..e@ee@.@e@e.ee.@eeee@e@e.ee@e@e....
..e.@ee.e.@e.@.eee@@.e@.e@@@@e......
w.@e.e@...e..e.@@.@ee..e.eeee....e.w
..e@...e@.@....ee@ee@.e@.e@......@..
..e.e@e.e.e.e..e.e.@ee@@e@ee.....e..
w.@ee@e..@ee@ee@e@....ee..@@.e.....w
..e@@e...e@..@..@e....@@e.eee@......
.............e..e@@e..ee@.@.........
w..e@e@e.e@e.e@e..e@....@eee@.ee@..w
......@e.e@e.@e...@.....e...e.@ee...
....e.e@.@........eee@e@ee@@e..@@...
w.ee@.ee.eee.ee@e.@@e.e@..eeee.ee..w
..@e.e@@ee@@e@@e..e....e...e@@e.....