33,36
354
354
1000
......e@.@e@..e@.......e@.....e.e...
w.e@e..e@eee...e@e......e..e@e@e@..w
..e.@e@..e@....e.........e.ee@@e....
..@@e@e@.e@ee@e@e@..e....@e@@.e.....
w.eee@ee.e@..e@.@e..@e.e@e.@ee.e@e.w
..@e.e@..ee..e@e..e@e..@e..ee@......
...@e@..e@e......e..@@e...e@@e......
w..ee@...e@.e@..e@e@ee........e....w
.....e.e@e@e@e.......e@eee@e.e@.....
....e@e....ee.e@e..e@e.e@.......e...
w.e...@e@..@@e.e@........ee.....@..w
..@@ee@.e..e@e@.....ee@ee@@ee...e@..
..ee@.e.....e@e@e@e@@e@e@ee@@e@..e..
w....e..@e@.@@e.@.@e.....@e..@e....w
....e@..e@e@ee..e.e@...e.e...@e@e...
.....@ee@.......@......@e@...ee@e...
w...ee.e@e@ee..ee...e.e@@.@ee.e@...w
..e@@e..e@e.@ee@@.e.@e.ee@e.@.ee.e..
...e.e@e.e@e..e@e@@e@e.@.e@.ee@@.@..
w...e@e..@e..e@e.ee...@eee....@e.e.w
..e@@e@..e@e.@e.e@@...ee@@e...e..e..
..ee@e.@ee.@..e...e.e...e....e@ee@..
w.@e@e@e@@ee..@e..ee@e..@e...@e@e@.w
...e@e@.e@e...ee@e@@e.......e@e..e..
......e.@e.e.e@@e.......e@e.e@e.....
w......e@e.@.e@e.e...e..e@.e@@e..e.w
.....e@@eeee..@ee@...@e@.e.e@ee@e@..
.....ee.e@@e.@e.e@..e@eee..@e.e@e...
w...e@@eee@e@e...ee.....@ee@e@e.@..w
..e@e@ee@@..@e..e@@e...e@ee@e@e.ee..
..@e.e@@ee..e@.ee..e...e@.e@e.e.e@..
w....@@e.@e...e@@..@e.e.e...@e@..e.w
...e@ee...@ee@e.e..e@e@e@.....e@e@..