33,36
363
363
1000
....@e.@e@..ee..@e..@ee@e..e@ee.....
w.@ee..e.e@e@@eee.e.e......@e.@e...w
..e....ee@....e@.e@..@e..e...ee@e@..
...@e@.@....e@e......ee..@e.e@...e..
w..e.e.e@e@e..@e....@e@.....e....@.w
...ee..ee..e..e..e.ee..e@..e@....e..
..e@@ee@eee@ee@e@@e@@e..e.....@e....
w...e.@e@@@e.e@.e..e.ee...eeeeee@e.w
...e@.ee@e@e.@e.....e@@.ee@@@@e.@e..
.....e@.@ee.@e...e...@e.@e.ee@..e...
w....e..e.@.e...e@..ee@e@e...ee....w
..@e.@ee.ee...e.e@e.@e@e....e@@.....
..e.@e.@e@@e.e@......e@e@e....e.....
w...e.e@.....@ee@e..........e@@ee@.w
..ee@.@ee@e.e@.@e.e.ee.....@ee@eee..
..@....eeee@ee@.ee@e@@e@e..e@...@...
w.e.eee@@@e@.@ee@@...e.@ee@.e@e@e..w
....@@e.e@ee@e...ee@e@.e..e...e@e...
..e@e@...e.@.....@ee@...@e@....@e...
w.@eee..e@.ee@e.e..@e.e.e@.....e...w
..e@@e.e@@e...e.@e@..e@.e.e@e@...e..
...e@e.e@e.@e@@e@.e..@..@e@@ee..e@..
w..e@ee@@e@e.e@eee.e@e....@e...@e@.w
....e@@ee@@e@e@.e@..e@..e.e....e.e..
....e@@ee@e.e.e........e@...........
w...@ee.@...ee....ee.@ee....e@e....w
...@e...eee.@@e@..@@.e@@eee@e.eee...
...e.e...@@.ee@e.@ee...e@@.e@e@@@e..
w....@...ee..@.e@e...ee..ee..e@ee@.w
....ee@e.@e..e.@ee...@@ee@@.e@.e@e..
..e@@e........e@e@@e.e@e@@e....@e...
w.ee@e.e.@e.e..e@.e@.eee@ee.e......w
..@ee@e@.e@.@e.@e....@e@.e@e@e@e....