33,36
352
352
1000
.......e@e@e..e@e..e@@e.@e...e.e....
w..e@e..ee@.e@@e@...eee@e@e..@e@...w
.....e.@e@e.ee..e.....@e.e@..ee.ee..
....e@.e...e@...@e..e@ee.@@e.@@e@@..
w.@e.e.@e........@e@e.e@.ee..e@e.e.w
..e.e@..e..e@..ee....@ee@e..e.......
..e@@e.e@e.@e@e@@e@e.e@@@e..@...@e..
w..e@.e@..e...e@ee@ee@.ee..ee...e..w
....ee...e@......e@e.e@@e.e@@e@ee@..
....e@e@ee@e.e.e@@e...e@@e@.e@@e.e..
w..e@@e@@e...@..e.@...ee@e..eeee...w
...e@e.e..e..e..e@e..e@e@...@@@@....
........e@@e@e..@@e@e@.@e.@eeeeee...
w...eee..ee.....ee.e@..e@.e.e@@@@e.w
..ee@@@e.e@e@e.....e@e.e@e..@eee....
..@e.e@e@@ee@@e.....@e.@e....e@..e..
w.....e.ee@.e.......e..........e@@.w
.....@e..e@e@.e.........e@e@e..@ee..
..e..ee...e@.e@.....ee..e@@..@e@....
w.@ee@@@e..........e@@e.@ee..e.e...w
...ee@ee...e@ee@e........@e..e@e....
..e@@ee@..e@@e@e@...e.e@e.....e@e...
w.e.......@.e@@e..ee@.@e.....e.e@..w
..@eee..e@ee@ee...@e.e@e...e@@e@....
..ee@@.ee@.@.e@@e@e...@e....e@@e....
w.@e@ee@@e.e.e@e....e@e.....ee.e...w
...@e@...@e..e@e..e@e@e.e.e@@@.@....
..@ee@e...e..e....e@e@e.@e.eee.e....
w.e.e@e...@e@@e.....e@e@...@e@.....w
.....e@@e..@ee@....@ee@ee.e@e....e..
....e..e..e.e@e@@e.e..e@@.e@@@e..@..
w..e@..@ee@.e@eee..ee.e.e..eee..@e.w
..e@..e@e@..e@ee@.e@@e@.........e...