33,36
353
353
1000
...e@e@e.....e@..e......e@e....e@e..
w..e@e@@e....ee..@..@e..@e..e@.@e..w
....e.e......@e@ee..e..e@@ee@e@e....
....@e...@e@e..e@.e@e..@e.e@.e..e...
w..ee@@e.e...@ee@.e...e.e....@..@e.w
...@e@e.e@..@e.ee.@e..@e@ee..e.ee@..
..ee@...@e@ee..@@ee.....e@@e.@e@.e..
w.@..e@ee.....ee@e@..e..@e@e@@e.e@.w
..e..@@e@.....@e...e@@.e@ee@ee@.e@..
.....ee...e.........ee@e@ee@..e@ee..
w.@e.e@e@e@e@e..e@@e...e@@ee...@e..w
..e...@e.@e@.e@e.ee@....ee@@...e....
...@e.eee.........e@e..e@@.ee@e.....
w..e..e@@e.e....e@@e..ee@e....e@e..w
........e@.@...@ee...e@e.....ee.e...
..e.....e@.e...e@...ee@@e...e@@e@...
w.@@e.e.ee@@e@ee..@e@.e@e....@ee@e.w
..ee.e@.@eeeee.@eee@@ee@@e...e.@e@..
..e.e@e...e@@@.e@@e.e.@e....e@......
w.@..e@e..e@ee.@e...@ee@@e.ee@e.e..w
..e.e@.....e@....e@e@@..e@e@.e.e@...
....e@..ee....ee.e..eee@e..e.@eee...
w...@e@e@@@e.e@@e@e.@@e..@e@.@e@@e.w
..e..ee@eee..e@e@.@ee@e..e..ee@e@...
..@ee@..@eee......e......@.e@...e...
w.e@.@e.ee@@e.@e.e@......ee@e@e..e.w
..e..e@e@@@e..e@e@..e.....@e....e@..
..@e..e@@ee...@e@.ee@....e..e@e.....
w.@e...@e@......e.@.ee..e@e.@e@e...w
..e....e...e@e..@ee.@@@e@e@...e@e...
..eee@e....e@e@e....eee@.......e@e..
w.@@.@e............ee@e@e..e@e@@e@.w
..ee.e.e@e........e@@ee@e...e.e.....