33,36
351
351
1000
...ee.e....@eee@.......@e...........
w..@@e@@e..ee@.e..@e@e.e....e...e..w
...eee@ee.e@@@e@e@e.e@e@.e@.@.ee@...
....e@e@@e@.eeee@.....e@e@e.e.@e@...
w...@e.e@e@e.@@e@e@e@..e@e..ee@ee@.w
......e@@ee..e@ee@e@e@e@..ee@e@e.e..
.....e@.e@@e@e@@e@...e@e..@e........
w.e.e@@e..e@@ee.ee@e...@e@..e@.....w
..@..@e.....e.@e@@..ee@..e@..e@.e...
..e..ee@...e@e@e.eee@.e..@e...e.@e..
w...e@.e..e..@eee.@e@...e@...e..e@.w
....e@....@...@@@e@ee.e@ee@.e@.@e@..
..e@ee....e...ee@@.e..e@..e....e.e..
w...e......@e...ee@@e..e....e......w
...e@......e@....@e@ee@@e...@e.ee...
....@e....e........e..ee@..e@ee@@e..
w...e@@e.e@....ee..@....@e......@e.w
..@e..e......e@@@e.e..e.ee.....ee...
..e.e@..e@.e@eee@@..e.@e@@@e.ee@@...
w....e...ee@@e..ee..@.e@.ee@e@.@ee.w
..e@..e@e@@ee.ee...ee.......@..ee@..
...ee@e@e..e@e@@@ee@..@ee...e..e@...
w...ee.e@.....eeee.e@@e@@...ee.e@e.w
...e@@.@.....e@e@@..eee@ee..@@e.e...
.....e@e@e.....e@e.e@.e@.@e.e@e.@...
w....@@e.@e@e........e@ee@e...e.e..w
..ee.ee.eee@e...e..e@@@eee@..e@@e...
..@@ee@.@e.e@@ee@...eee.@@@ee..e....
w.e@.@e....e@e.....e..e@eee@@......w
...ee@e...e@@e...e@@.ee@e@@@ee......
...@.@e....ee...e.eee@....eee@......
w.@e.e...e@@@..e@.eee@e.@e.........w
..ee@e...@eee.e@ee@@e@e.e@..e@e.....