33,36
347
347
1000
...e@......e@..e@..e@e..e....e@.....
w...e...e..@e.e.e@eee@ee@.e@e.e@e@.w
..@e..@e@@e@e.@.eee@..@e..@......e..
..ee..e..ee...e.@@@e...@e.e...ee....
w..@e.e@ee@.@e..ee@e..@e.....e@@.e.w
..e@ee...@@ee....ee@..e........ee@..
..@..@e@eee@....e@..e@........eee@..
w.e..e@e..@e...e@....e@......e@@ee.w
....@e@@e@ee...e..e..@ee..e@e@......
..e@e.e.ee.@ee.@..@e...@..e@........
w......e@@e.e@.ee@e...ee...e.....e.w
..@ee@ee@e@ee@ee@.@e.e@.e@e@....e@..
..e@@e..ee@@@e.e@e@ee@..e@e....e@e..
w..e@@e@@@eee@..ee@@e.e@e@@ee.eee..w
...@e.@eee.e@..@eee.e....e..@e@@@e..
...e@..e@@e@e@@ee@.e@.e@e.ee.e@ee@..
w..@e..@e@ee.ee.e@...e@e..@@@e...e.w
......e@...@e@e@ee...@e@..eee..e@@..
..e....e...ee@@e...@e@....e.@e..ee..
w.@...ee@....e@@e@.e.e...e@...e@...w
..ee@e@@ee@e..e.@ee@...e@e....@e....
...e@@ee@e@e.e@.e@.....@e@.e@.e@....
w.e.e.e@e@.e....@@e...@e.e..e@e....w
..@.@e@@eee@....ee.@e.e..@e......e..
..e..@ee@@....e....e..e@.e@.....e@..
w.e@...e@e....@.e@e@..@ee@...ee@e..w
..@e.e@e.e@e..e..e@...e@@ee.e@@e....
.........@e.....@e.e.e@e@e@..e@..e..
w..@e@e.e@e.....eee@e@.e@e.e@@ee@@.w
..ee..e@e........@ee@.e..@.@e@e.ee..
..@...e@......@e.e....@e.ee....ee@..
w.e....e..e@..e@.@e..e@e..@.@e@@e..w
..@e......@e..e@e......e@ee.e.ee@...