33,36
363
363
1000
..@e..@e..e@e@e...e..@e.@e...e......
w.e...e..e@@ee@.e@@e@e..e...e@e@e..w
..@e...e@e.e....@e..e@ee........e@..
..@e....e@.@...e@@.e@e@@eee..e@..e..
w.e..e.....e.e..ee.....ee@@e..e..@.w
..@e.@.e@@e..@e.@e.....@e@@ee.@e@e..
..e.ee..ee...@e......e...ee.@...ee..
w.@e@...@e...e.......@@e@e..e@ee@@.w
..e...ee@..e....ee...ee.......e@ee..
..@e.e@.e..@....@@e..e@@ee...e@@e...
w.@e.@e@e@ee..e@e@e.e@.ee@@eee@e...w
..e..ee@e..e@ee@e@e.....e@ee@@e.....
............ee...e@.e@..e....@e.e@..
w..e@e...e@e@@e.e@..ee.e@...ee...e.w
...ee..ee..e@e..e@..@@e.....@@e.....
...@@e@@@e.e@@e@.e.@e@ee@ee@e....e..
w..e@eee....e@ee@eee..e@.@@ee@e.e@.w
..e@@e.@.........e@...@@eee@.....e..
..e.e..eeee..e...e...eee.e@......@..
w.@e.eee@@@e.@e..@e..@e.e.@e@e...e.w
..@e.@@@ee...e@...e@e.@e@.ee@e......
..e..ee@@e..e@@e@.....e@e@e..@e.....
w...e..e@e@.e.e.ee...e@e......@e@e.w
...e@..e@@e.@e@e.@..e.e@...e@e@@e...
.......@e..e@@e@.e.e@.@e.e@ee@e@e...
w...........eee...ee@e.e@e.@...eee.w
...eee..e.e@e@@@ee@@e@e..@.e...@@@..
..e@@@ee@.eee@ee.e@e..@eee@e@e@eee..
w.e@e.e@.e@@.e@......e@.@@e@e@.eee.w
.....e@eee@ee@..ee@...e.e@e@..e@@@..
.....@e.@.e@e@ee@.e..@e.e@.e..@eee..
w.....@eee...e.......e...ee@.e.e.e.w
...e@e@e.@e..@e@e@e@ee@e....e@e@e@..