33,36
368
368
1000
..e@eee@e@.e@e@e.e...e@e@e.e@eee.e..
w..e@@e@.eeee.e@.@ee@..e.e@e@.@@e@.w
..e..e.e.e@@@@e.e@e.e@e@....e.ee@e..
..@.......@eee..e.@.e@e.....e....e..
w.e.......e..@.e@@e.@....@ee@....@.w
.....@e@e.e.ee...e..e....e...e...e..
..e@ee...e@e@@e@@e..ee..e@@ee@......
w.@e@@.ee@.e@e.ee.ee@@e@eee@@@e....w
..@e.ee@@...e@e...@e.e@e@@e.ee......
..e.e@e@ee.e@.@......@....@e@..ee@..
w.@e....@@.@..e@...eee..ee@ee.e@ee.w
..e.....ee.ee@@ee.e@@e..@e@.@ee@@e..
..@e.......@.e..@..@e@....e....e@e..
w.....e....e.e@eee.e.@eee@@..e..@e.w
.....e@...e...ee@@e.eee@eee..@..ee..
..@ee@.ee@@e.e@.....@e@@e.@..e..e@..
w.ee@ee@.e@e..e@.e@e.e@e..e...@ee@.w
..e@@e........@e@e..e......eeee..e..
....ee@.........@e.e@.....e@@@e.e...
w.e@e.e.e....@eee.e...e@e@.@ee@.@e.w
..@...@e@@e.@e@@ee@......e@e@e@.@e..
..eeee@e.e..e.e@.e@@e.e.ee....e.ee..
w..@@eee...ee.ee.eeeee@e@@e...ee@@.w
..ee@e@@e.e@@e@..@ee@@.ee.@e.e@..e..
..@@.@@e...ee@.......ee@@e@@e...e@..
w.ee.ee...e@@.e....e@@...@e.e@e....w
..@e....e@eeee@..e.@eee.@e..........
......e@e.e@e@...@.e..@.ee@ee..e@...
w.....@e@e@......e.@e.e.@e..@...e..w
...e........e......e@@e.ee..e...e@..
...@.....e..@e...e@eeee.@@ee@e@eee..
w.ee.....@.@e.e@eee@@e@.e@e@.ee@@..w
..@e.....e@e.e@.e@@e..e@e@e.e@@ee...