33,36
363
363
1000
..........e....e@e.e@@e....e@e..e@..
w.........@e...e@e@.ee@e@eee.@@e.e.w
..e..e..ee@@e@.ee@e..e@@.@@@.ee.....
..@e.@e.@ee..ee@......ee.eee.@e.....
w....@e@e..e@.e@e@...e.e@e.@e......w
..@e.ee@....e....e@ee@@ee@@e@..@e...
..e..e.e.ee@.e@..e.e@ee.e.e....e....
w..@e@..e@@e..eee@e.e@.e@e...ee....w
..ee@...e@e..ee@e@@e@ee@@e.e@@@e.e..
..@@ee..e@.e.@e..e..e@@eee..eee@e@..
w.ee@@e..ee@@e........@ee@...@eee@.w
...e@ee@e@..e..@e.....e@....ee@@@e..
..@e...@e.e@e.@e.....e@..e.e@@ee@e..
w.e@.e.eeee@..e...e.e@@ee@@e.e@e...w
..e.e@..@@@e..@..e@...e...e.@ee@....
..@e@.@eeeee@ee.e.......e@e.e.@e....
w...@eee@.@@@e.e@...e@..@e...e@e...w
..e.e@...@eee.e@.e@e.e.e@@e.e.@e....
..@e@....e.e@..e@e@e....ee@.@ee.....
w.@e@e..ee..e...e........@e@@e@e...w
..e@e@.e@@e.@@e@.......@ee.eeee@@e..
...ee..e@e@.ee.e.e.....e...e@@e.ee..
w.e@@@ee@e..eee@e@e@......e@..@.e@.w
....ee..e@.e@@@eee@e..e@e.@e..eee...
...ee@..@@e@@e.@@@....@e@..@..e@@...
w.e@@e..ee@ee@.eee.e@e...e.e....ee.w
..@e@e.e..e@..e@...e@e.e.@e.....e@..
..@e.e@@...e@.@e..@ee@.@e@e...e.@...
w.eee.ee@...e.e@..e@@e..e@@e..@ee..w
..e@@e..ee@e........e...ee.....@....
..e@e@.......@e.....@e.e@.e....ee@..
w.@@e.eee@e..e.........e@e@..e.e.e.w
..ee.e@@e.......e@e@e..@e...e@e@....