33,36
355
355
1000
..@e..e@@e....@e@...e....@e...e@@e..
w.e@...ee@..e.e.e.e.@e.e.e.....ee..w
......e....e@....e@...e@e@.e@.e@....
..e..e@....e@e....e@ee@@ee.@e.......
w.@e...e@e@...e@@e@e@..e.@ee@..e...w
....@e....e..eeee@......ee.e..e@....
...@e....ee@e@@e@....@ee@@.@e.@.e@..
w..e.@e@e@.e.e@e..e..e.eee....ee.e.w
..e@@ee@ee.......e@e@@e@@@.e.e@@e@..
..e@e....@@e..e....@e...eee@..@e....
w.@e.....ee@.e@.@eee.@ee@e....e@...w
..@e.........@e@ee@@ee.e.@e...e@....
..e@e@e@...e..e...e@ee@@..ee@e.e@e..
w.e@@e@e...@e@@.eee@e@ee.e@e@e.....w
...e@e...e..@eee@@e@e....@@e...e@...
.........@e..@eee.e@e@e@eeee....ee..
w...ee....e...e@@eeee.e@e@e@e....@.w
....@@e@..@e..@e..@@@ee@ee@@e....e..
....e@@e.@e..e@e..ee..@e@@@e...e....
w.e@.e..ee...@ee@e.......ee.e@e@.e.w
...eee..@......e@@.e@..e@@e@ee@e@@..
..ee@@e.e@e@....ee.eeee.ee.e@.e.ee..
w.@@e.@e.e.e.e@e@@e@@@@e...ee.@e@..w
..e...e@eee..e@e@ee@eee@...@@e@.....
..@...e@@@@e@e...@eee@e@...ee.e.....
w.e.e@eeee@@....e@e@@e.e....e@e@ee.w
..........ee.....eee@e.e@e..e@@@e@..
...........e....e@@e@e@ee@@eeeeee@..
w.......e@.@e@e.e@e@..e@.@e.@e@@ee.w
..e......ee@@e..@e...e...e@ee.......
..@e@..e...e..e@@e..e@e....@@...@e..
w...e..@e@.e@e.ee...@e.e@eeee...e..w
...e@....e@e........e@.@ee@.........