33,36
350
350
1000
...@e..e...e@.e@e..e@..e@e..........
w..e@e@@e...e.e@e...eee@@ee..e@e...w
......ee@..e@...ee.e@@eeee@....@....
..e.e@ee@ee@...e@@e@@ee@@..e@e@e@e..
w.@e...@e@@e...e@...e...e.e@.......w
....e..@ee@e@..ee.e.......e..@e.@e..
..e.@e.e..eee@e@.e@e...e..@e.ee@e...
w.@e@e@.@e@@@e@@e..@..e@...........w
..e@@ee@e..eee@e...e..e@e@.e@e......
....e.e...ee@e.e@ee@..@e.e..........
w..e@.@e..@@ee@e@e@.......e....e...w
...ee@e@..e@@ee@@e@e@e...e@....@e...
...@@e.....e.@eee.e@e..e@@@ee..e@...
w..e........e@e@..@e@..eeee.@e...e.w
..e@.......@e...e@.e@.e@@e.e....e@..
..@e.......e.....e.@e.e@eee@ee@ee...
w.e..e@...e@.....e.....e@@@e@e.e@..w
..@..@ee@ee@e...e@@e.....e.e@@@e....
..e.e@e....e@e..@ee@e@e@...@eee.e@..
w...e@e.....e@.e@e.e@.ee.ee@e....e.w
...e@@eee......@e...ee@e@@.e....e@..
..e@ee@@@.......@..e@e@@eee@...@ee..
w..e@.@ee.......e...eeee@.e@..@ee@.w
...e@.e@..ee@......e@@e@...e..e.e@..
..e.e.e..e@@e@e....@e.e.e@..@e@e@e..
w.@e@.@ee@.........e..@e.e..e@.@...w
..e@..e@.@e..@e@...@.e@@e...@e@e@e..
..e@..@..e@eee.e...e..e.e...e..e....
w..ee.e....@@ee.e...e@.e@e.e@..@e..w
..e@@.....eee@@e@@e.@ee@@e..e.e@e...
...@e..e..@.e.e@.ee@ee..e.e.@e.e....
w..ee@e@@eee@ee.e@ee@@e..e@e@e@@ee.w
....e@e@e...e@@e@....e@e@e.@e.e.e@..