33,36
355
355
1000
..e@e.e@e.....e@e......e..e@ee@e....
w.e@e@e@e....e@....@e@e@..@e@..@e..w
....@e........@e...e.e..e@@e..e.....
..e.e@e.e@ee..e.......e.@eee..@e@e..
w.@e@e@e@e@@e.e......e@...e@.....@.w
..e.e.@e@e.@e.@e.....e..e.@....e@e..
....@@ee@e.ee.e@....e@..@ee......e..
w..eee@e@e..@e@.ee.....ee....ee.e@.w
..e@@.e@e@.e@e.e@@@e@ee@@e@ee@@.....
....ee@@e.@e@e@e.ee.e@ee..e..ee@e...
w.e@@e.e..e.ee@e....e@@@.e@@e@..@..w
..@e@ee@....e@@e@e.e.eeee@ee..e@e...
....e@..e.e@e@e.e@e@e.e@@@e.....e...
w..e@..e@.e@e.......@e..ee...@e.@..w
.....ee.e@e@ee..e..e@@..e@.e@e..e...
.....@@e@e...@e.@e@.ee@e.e@..e@.e@..
w....e@e@@e.e@e.eeee.e@..@e...e..e.w
....e@e.e...@..e@@@@e.ee.e@..e@e.@..
......@e@@e.e..e.ee...@@e..e@@@e.e..
w.e......e...e@@e@.e@.ee@...eee.e..w
..@e..........e@e..@e..@e......e@...
..ee@e.e.e.e....@..e@ee@e@e....e@e..
w.@@@e@@e@.@e@e@e..@e@@@e.e@e@.@e..w
..eee.ee...ee@@@ee.e..ee.....e...e..
..@....e..e@.eeee@.....@ee@ee.eee@..
w.e....@......@.e@e@e..e@@e.@e@@.e.w
..@.e..ee@e...e.e@e....e@ee..@eee@..
..ee@e@@.e..@e.e@..@e..@ee@....@.e..
w.....eee@..e.@e.e.e..e@e.....@ee@.w
..e@e@.@e.....e..@.......e....e.e@..
..@.@e@..e....@e.e...e@ee@..e....e..
w.e@e.e..@...e@ee.....e@e@e@@e..e..w
......@e.e@e.@ee@...e@e@e@ee@e@e@...