33,36
367
367
1000
..ee@e@@e..ee......e@e.ee@ee@.e@e...
w.@ee.ee...@@e....ee.e.@e@e.e.e@e..w
....e.e.e@eee@...e@@e@.ee@@.........
....@e@.e@e@e@e.@e@e@e.@.ee....e@e..
w.@ee...........e....@eee@e.@ee@...w
..ee@@e@..e@ee@.....e@e.@...e....e..
...e@e.e.e.e..e......e@ee...@e.@e@..
w...e..e@@e@e.@e@e...@.....e@@ee.e.w
...e@e..e.e@@@ee@....e..@e..e@e..@..
.....@..e@.eee..ee@e...@e.ee.e...e..
w....e..@ee......@.e@e.e.e@@e@.....w
...e...e@e@......e.e@ee...e@e@e@e@..
..e@...e@........@e@.e@........@ee..
w.@e@e..e.e@.........e@.@e..ee.e.@.w
.....@..e@.e@ee....e..eee...@@.@ee..
.....e.e@ee...@e@e.@ee.@e...ee..e...
w....e@@e@@e.e@....e@@e@e.@e..ee@e.w
...e.@e...e@.ee.....e@@@e.e.@e@@....
..e@eee@@e@@e@@e.e...eee.ee.ee@e@e..
w.@e.@eee..e@...e@.e...ee@@e.e@e@@.w
..e@e@eee.e.e...e@.@@e.@e@e@e..eee..
.....@e@@e@e@....e.ee@...e..@e@@e@..
w...ee.e@e@e@eeee.e......@e@@eee@e.w
...e@e@...ee@@@@@e@...@e@eeee.ee@e..
..e@..e@ee@.eeeee@..@eee.e@@e.@e@...
w.e@e.@ee@.e@e.@@...e.e@..@e....e..w
....ee.@e...e@.ee...e.....e...e@e@..
...e@@e.....@e.....e@...e...e.e@ee..
w..@e....ee@e.ee.ee.@e@e@.e@@e@.e..w
...e..e@e@e@@e@@e@@ee....@eeee..@...
...@.e@e@@eee@e@ee.e.e.e.e...@..ee..
w..ee@@e.e@@e..e@@e@.@e@.....e..e@.w
......e....e@.e@......@e...e@e......