33,36
345
345
1000
.........ee.....e@...e.e.e..@e......
w.......e@@..@e..e@e.@e@.@e.e..e@e.w
.....@e.@ee.ee@e@e@ee@e@e..e@...e@..
.....ee@ee.e@e@ee@..@.@.e@.@...e@e..
w.e..e@e.@.@e@@e@..ee@e..e.e.e@e@e.w
..@ee@e@.e....ee@e.@.@e@.@....ee@e..
..e.@e.e@......ee@ee.e@e.e....@e....
w.@e....e..e..e@@.@e...e.@e@e@e@e@.w
....e...e@e@.e@eee....e@...ee@e.@e..
..e@@e.@e@@ee@e@e@...@e...@e.....e..
w..e..@e.e..@e..@ee..e@e@ee.....e@.w
...e@@ee.........e@.e....@....ee....
....ee@@.ee..e...e@e@....e..ee@@e...
w....@@ee@@ee@....e.....e@.e@@e@e..w
.....ee..e@e@....e@.....@e.@e@e.....
.........e@................e.e......
w.ee@e@e@ee@e.e..ee..@e......@@e@e.w
..@e@ee@..e...@ee@@@ee....e..eee@e..
..ee@e..ee@..e.@@eeeee....@@ee@@....
w.@.e@e@@@e.e@@ee@.e@@e.e.eee@@e@e.w
..e...@ee@e...e.....e@ee@..e@@ee@...
..ee@.@e@......e....e@.e@e.e@ee.e...
w.@ee.ee@e.e.ee@.....e.@e..e@e@....w
.....e@....@e@e@e.@e...e@..e@@e.....
....e@@e.e...e@@e.e@@e.@...@ee@e....
w.ee..e..@e@e@.ee@e@e..ee@e@@ee@...w
..@@e......@e@e@@e@.e@.@e@@e.@e.ee..
..ee..e@...e@.@......e@e.ee...@e@@..
w.e@...e.e.e@.ee.......@e.@e@.ee.e.w
.........@..e.e@............ee@@e@..
.........e..@e..e..e.e@e@@e.....e@..
w.e@e....e.e@e..@e@@e@e.ee..e@e..e.w
..e@ee@e.@e@e...e.e@e.@e.@e..e@e@e..