33,36
362
362
1000
...e.e.e....@e...e@@e.ee@...@e@e....
w..@e@e@@e.@ee@...ee..@@e...ee@....w
.....e@ee..e..ee.e@@..e.....@eee@e..
..@e.e.@e..e...@.e.e..e...e@........
w.e.e@.ee..@e@.ee@@e.e@@e.ee...@ee.w
..@..@e@@....ee.e@ee...e@.@e...e@@..
..e..ee.e...e@@e..@@e@..@e..e@e..e..
w.....@@e.e.e@@ee@ee.e..eee..e...e.w
......ee@e@..eee@...e....@@ee@e@e@..
.......e@@e..e..e@..@e@..e.....ee@..
w.@e@ee.ee@..@e..ee@@ee..e@...e@.e.w
..ee..@e@....@ee...ee@e...e...@ee...
..e@@e@.e....ee@ee@..e@......e.e@e..
w.e@eeee@.e@e.ee@ee..e@e@e...@..e@.w
.....@e.@e...e@e@@e.e.e@e@@e.e.@e...
....e...e@....e.e.ee@.@e..ee.e@e@...
w..e@.........@e@e@e@e@.e@@@e@@ee..w
....e@e.e@e@....e.e@@ee@@eee@@ee@e..
..e.e@@.@@ee...e@.@ee..ee@e@.e.@.e..
w.@e@ee.eee......e@.....e@e@e@.e@@.w
..@e.....e@@e.....e...e@ee.e@...ee..
..e..ee@e.@e.e.e@e..e.e....@........
w....@..@.e..@.....e@e@...eee.e....w
..e@ee..e..e.ee@..e@ee@e..@e@e@.....
...ee@...e.@@e@e.e@.e@...e.e@@@e....
w..@ee@.e@eeee@.e@ee...e@@e@eee....w
....@@e@@@e.@.ee@.e@.e@.eee@@@e@e...
....e@eeee@.e..@e.....ee@@@ee.......
w.e.e.e@.eee@...@e.....@eee.@e.....w
..@e@e@.e@@e.e@.e@......e@@ee@......
..e@.@e..e@...e......ee@ee@.@e.@ee..
w.e.e...e@e..e@....ee@@e.@e...@ee@.w
..@e@..e@.e@e.....e@@e....e@e.e.....