33,36
364
364
1000
..@eeee.e@.e.e.e@..........@e....e..
w.ee@@@eeee@.@e@e.......e@.e..e@e@.w
..e@@ee@@.e@e..e....@ee..e@e..@e....
....e.@ee....e@@e...e.@...e@e@e@....
w.....e..e.e..e@....e.e..ee@e@e.e..w
..@ee@@ee@e@e@ee.eee@@e.e@@e.@e.@e..
..e..e..e@@.e@.e.@@..e.e@....e......
w..e@e...ee..ee@eee.e@.e....@e.ee..w
.......e.@...e@e..e@e..@e..ee.e@@e..
.......@ee...@@e....e@e@@e@@e...e@..
w.e...e@e....ee.e@e@@e@e@ee@ee@e.e.w
..@ee.@.ee.......e.ee..e@e..@....@..
...e@@e.@@......ee..@e..@e.ee@...e..
w....e..ee@e@.ee@@e.@ee.e@e@@e.e@..w
..e@..e.@ee@ee@@e@..ee@...@e.e@.e...
...e.e@e.@e@e..e.e....ee.@ee..e.....
w......@...@e.e@.ee@@e@@ee.@e......w
...e.e.e@eee.e@..@.ee@e@e@e@ee@ee...
...@e@@e@.@@e@@e.e.......@e..@e.@e..
w.e@@@e.e@ee..e......e...e.@ee@e@e.w
...eee@..e@@ee@......@e@.e.e.@..@e..
.....e@e@e@....ee.e@...ee@e..ee@e@..
w.@e@e@e@ee..@e@@e.e....@eee@e@@e..w
..e....ee@...e@e@e......e@@e...e@...
.......@e@...@e.e@e...@e@....e@@e...
w.@ee..@ee..e@e.@....eee@e....e..e.w
..e.@..e..e.e@e.e...e@ee@eee....e@..
...@e.....@e.......e..@.e@@@e.......
w.ee@.....ee@e.....@e.e@e.eeee@.ee.w
..@e..e.e.@@.e...e.e@.e....@@eee@@..
..e.e@@e@@eee@..e@@e@e@@e..e@e@@ee..
w.@.@ee@@e..@e.e..e.e@ee........@..w
..e..e@ee...e@e@e@e...@e@ee@e...e...