33,36
361
361
1000
..e@e@e@e.e@ee@@e..e@e..e@ee.e.e....
w..ee..@e.@e@.ee...e@e.e@@e@e@.@e..w
..e@@e.e@.e..e...........e@e.@e.....
..@e.e.......@e@..........e@.e......
w.e.e@........ee.e@...e@.@e@ee.....w
..@.......e@..@e.ee.e@ee.e.e@@e.....
..e.ee@e..@ee@e.e@@ee@e..e@@e.......
w..e@e@e.ee...e@e@e@....e.e@.......w
...e@@e..@@e@e.e@...ee.e@.@e...@e@..
..e@e...@eee.e.....e@@e@@e.....e.e..
w.@e...ee@e@e@......e@@ee.e@e.e@.e.w
..ee...@@ee@e.@ee....e.@e@e@@e...@..
..@@e..e.@e.@ee.@......e..eee@.e@e..
w.ee@@e.........e......@e.@.@e.e...w
..e..e.....e@e....e@e@ee..e.@e.@....
..@ee........e.e.....e@@.e@.e@ee.e..
w.@e@...ee@@e@.@e@...@.e...e@@e@.@.w
..e...e@@@eeee.e.e...e..@e.@@e...e..
..@e@..ee.e@@@ee@e...e@@e@eee.......
w.e.ee..e...e@.e@.....ee.e@.ee.e...w
.....@e.@e..ee@eee@.@e..e@..@@e@....
..ee@..e@e@e@..e.@e.e...ee..ee.e@e..
w.@@e..e@@eee..@.e....@e@@e..e@e...w
..e.....e@e@@e.e@@e@..e..e@.e@e.....
..@e@e.....e@...e@eeee@e..e.@eeee...
w.......e..ee...e.@e@@.e.e@e@e@@@e.w
..e@ee@.@..@e..e@ee.@ee@e..e@e.ee...
..e@e.e@e..e@e..e@@ee.@ee@e...e@@...
w.e@.e@e.e.@e@...e@@e@e@....eee@e..w
...e.@.@.@e@e@@e..ee.ee@e.e@@@..@e..
...@ee.eee...ee@..@.e@@ee@.eee.e@e..
w.e.e@e@@e@e@e@...e..e..@e.e...e@e.w
..@e..@e....e.......e@.e@ee@....e@..