33,36
350
350
1000
....e@e..e@..e@.....e@e@............
w.e@e.....e..@e....@e..ee@.....e@e.w
..@.e@e....e@e@....eee...e......e...
..e.e@.e@e..@e.@e.e@@@...@e..e@e@e..
w.@e.e.@.e.eeeee@@e@ee@e..@e.e..e@.w
..e@.@ee.@.@e@@e.e.......e.@e@@e@...
.......eee@e.e@ee@e...e..@e@@.ee....
w.....e@@ee@......@e..@e.e.ee..@...w
......ee@..e@e...e@@e.@ee@...e.e....
..e@.e@.eee@e.....e@..e@.e.e@@e.....
w..e.....@e@@..e@.ee...e@@eee@e.e@.w
..@e..e@...ee...e.@ee@e.ee@@@@e..e..
..e...@e......@e@.@e.e@.@.@eee......
w........e@..ee@..e@e@.ee.ee....ee.w
....ee@...e..@eee.e@@.e@..@@e..e@@..
...e@.e..@eee@e@@e@ee.@ee.e@...@ee..
w......e.e@@e@ee@e@e....@e.e@ee@.@.w
.......@e..@eee@@e.@.@e.e@.....e.e..
...@e..e@..e.@..ee@e.e@..@e....@ee..
w..e....e@e.@e.......e.e.ee@e.e@.@.w
........e@@ee.e..e@.e@.@.@ee...eee..
..e.....@e@e@.@...e@e..e@e.@e..e@@..
w.@e.ee@@e@e.@ee@e@@e......@e..@ee.w
....e@.ee....e.....e.......ee..e@...
....@@e..e@e.e@......@e@e@e@@e@e....
w...ee..e.@e..e.@e.@ee.@ee@@ee...e.w
......e@@eee.e..e@.e@.@e...ee@..e@..
..e@e@ee@e@@.@e@e@@ee@e..e@ee@e@e...
w.@e@ee.e@@ee@ee.ee.@e....@ee@e....w
...ee@@...e@e@e....e..e@..e.@e@.....
..e@..e...@.e@e.e@.@@e.e......e@e...
w..ee..e.ee@e@e@.e@ee...ee..@e@@e..w
..e@@e.@e@.e@..ee@.....e@@e.e..e....