33,36
352
352
1000
...........ee@e@.e@@ee@.ee.e@.e@e...
w...e......@@e.ee.ee@.ee@@@eee@e@..w
...e@@e...@e@@e@@e@.....@eee@e......
...e@e....eeeee@eee@...eee@@e@@e....
w..@e......@ee@e@@@ee.e@e@.e..e....w
.....e@e...e@e...e.@@.@e@e...@ee@e..
..........e@e@...e@ee....@e@ee.e@e..
w.............e..e@e.e..eee@e..e@e.w
.........e...e@..e@@e@e.@e......e@..
....e...e@...@e..ee.e@@.........e...
w.e@@ee@e.......e@@e.ee@.....ee.@e.w
...e@e.e@.......e@e@e.@e...ee@@e@e..
..@e@e@@e....e......@..e@ee@@ee@e...
w.eee.e....ee@.....ee..e@@@ee@e@@e.w
..e@@e@...e@..ee.e@@e...ee.@e.eee@..
..ee....e.....@@e@e.........@e@.e...
w.@@e@.e@e@e..e@e.@ee@e....e@e.e@e.w
..e..e..e........e@@e.e..e.e@e@e@@..
..@e...e@@e@e@e@e@e.ee@.e@...@e.ee..
w..@e..@ee...@e...@.@@e@e@....@e@..w
..........ee.e@e..e.ee...e......ee..
....e@eee@@@ee.@.e.....ee.ee@e@e@@..
w..e@ee@.ee@e@@e.@e....@@e@....e@e.w
..eee@e@e@....ee@e@....eee@ee@e.....
..@@@.@eeee..e@e@e..e@e@@@e..@e.....
w.eee...@@@...@e.@...e..e@ee.e@e@e.w
....e@e@eeee@ee..e.ee.ee@..@e..@@e..
..e@e...@e..e@.e@ee@@.@...e@e..ee...
w.@ee.......e......eeeeeee.@e..e...w
....@.......@.e@@e.@e@e@@@@e@.e@....
..e@e@......e.@ee.@ee@@eeeee@.......
w.e..e...e@....@e@e.@e@e....e......w
..@e.....@e..e@ee@e..e@e@e..........