33,36
353
353
1000
.........e@e...........e@.e@@e.eee..
w.@e.......@...........@e..ee.e@@@.w
..e@@e@e.e@e.....e@...e@....@e..ee..
..eee.e@.....ee@e.e..@eee@.e@e.e@...
w.@e@.@e....e@@e..e@ee@..ee@@e..@e.w
..@e@e.@e@@e.e@e..e.e....e..e...e...
..ee@@e..ee@.@e..e@e@....@e@@ee@@...
w..ee...ee.......@e@.......ee@.eee.w
..e@...e@@......eee@eee.e@@e.....@..
..@@ee@@ee.@e..e@@@e@@@eeee.....ee..
w.ee@.e@e..e.....eee@e@e@e@.e...@..w
..e.@e@.e@e@....@e@@..e@@e.e@e@.ee..
..@.e.@ee@@..@e.ee@e..@@e.e@e.e.@@..
w.e.e.e..ee..e.e.e@e@.eee...@e.eee.w
..@e@..e.e..e@.@ee.@e.@e@..e.@.@e...
..e...e@.@e....e@@e@..e@...@.e......
w.@eeee@e..e@ee@...ee@e....e.......w
....@@@e@.....................e@e...
....eeee..ee....e...eeee@e.e...e@...
w....e@@e.@@e.e@@e.e@@@e..e@.@ee@..w
..@e.@e@e@ee@.@e@..@.e@ee@e..ee@e...
..e.@ee@@eee@e..e.ee..@ee@e..@@.....
w..@e@.e.e@@e@....@..ee@@eee.ee....w
...e.....e@.......e..@..e@@@..e@@e..
..e@..e@e.ee@e....e@ee.e@@ee@e.ee...
w.@e......@e@.@e..@e@...eeee.......w
..e@........e.ee.......e@e@@e..e.e..
..eee......e@e@@e...e@ee@.e.e@e@e@..
w.@@@e@e@ee@........e@@ee.@e@e.....w
..ee..ee@@@@e..e.....ee@...e@@......
....e@..eeee@..@e.ee@......@ee.e@e..
w..eee....e@@ee.ee@.ee.ee.e.e..e...w
..e@@e@e....ee@.@e.e@@e@@e@.@ee@....