33,36
354
354
1000
...@e..e@e...e.e@ee@....@ee@e..ee...
w..e@e@e.ee@e@@e...ee@e@e......@@e.w
..e...@e.@.e..e@.@e.@.e@ee@e...e....
..@e..e@.e.ee...@ee.e....e@e........
w.e@.e....e@@.e.e.@e...e@e@e....e@.w
...e@@e.@ee.e.@..e@e@....ee......e..
....ee@ee@@e..e...e.ee@ee@@e..ee@e..
w...@@@e..@e@e@e@...@e@......e@.e@.w
....eee...e.e@..e.....e......@ee....
..e.e@@e.e..@e@e@..e@ee.....e@@@e...
w.@.e@e.e@.......ee@.@@e..e..ee@e..w
..eeee@e@e@e@e..e@@e.e....@@e@e@e...
..@@@@e...e.@e.e...ee@ee..ee..@@e...
w.eee.......e.e@@ee@e@@@...@eeee.e.w
..e....e@...e@@.ee@e.eee@e@e.@ee@@..
..@eee.@ee.@eeee.@@ee.@......e@.ee..
w.ee@@e@@@ee@@e@eeee@.e......@.e...w
..@..@eee@.@e...@..e@....@ee@e@@e...
..e..e...e....e.e...e...ee@.@ee@e...
w....@e..@e...@e@eee@@ee@@..e..e@e.w
......@ee....e@..@@e.ee..e.e...@e@..
......e@@ee...e.@e@...@...e@@e@e....
w..ee.@e..@.....e.e..ee@e...e.@e.e.w
..e@@@e...e@e@.......@@e......e.e@..
..@eee@....e.e@e..@e@e.@.......eee..
w..@e@.e...e@@e.e.ee...e...e@.e@@e.w
..e@e.e@@ee@ee@.@.@@e..@ee.@e..@e@..
......@eee@e....e@ee.....@.e@@ee.e..
w..e...e.e@@e...@ee@e@e..e...e@.e@.w
..e@e.e@.@e@.e@...e@@...e..e@@@e.e..
..@e@.e@e..ee.e....ee..e@.e@eee.e@..
w.e..e.e@.e@@@e..e@....@..@e@@...e.w
....e@......ee@...e....e.....e..e@..