33,36
354
354
1000
..eeeee@e@.e...e@e@e..........e@e...
w.@@@@e@eee@ee@ee..e@e@....e@.@@e..w
..eee@ee@e..@e..e@....e@e...e@eee@..
.....@e.e@@e.....e.....e@.ee.....e..
w....e...@e@.@e@e.e...e@@e@@e......w
.........e...e....@e....e..@e.e.e@..
...e@..@e@e@...e.e@.e@e.@..eee@..e..
w.@ee@.e..@e.e@@e@e...e.e.e@@e.....w
..e@.e........ee@.@e.e@e...e@e.e@...
...e@.....e....@.....@.e@ee@..e@e...
w..ee....e@@e..e....ee..@e.@ee@..e.w
..e@e@e..e@eeee.ee.e@@..ee.ee@e@e@..
...e@.@e.e@e@@@e@@...e@.@@e@@@ee....
w..@.@ee.@ee@ee@.ee@..e.e.e@ee@....w
...e.e@@e.@@@e.e.@eee........e@e@e..
..e...e@e@eee..@ee@e@.@e.....@ee@e..
w.@e..@@eeeee@e.e.e@e@e....e...e...w
..e@e@eee@@@e@ee@e@@ee....e@.e.@e...
........e@e@e@ee@@eee@...e...@e@e@..
w..e...e@.......e....@e..@...e...e.w
...@...e@e....ee....@e.@ee@ee@ee@@..
...e...e@e....@@...@e..e..e...@.ee..
w......@e@....ee...e..e@..@e..eee@.w
.......ee@e..e..ee.......e.@ee@@@e..
....e@.e....e@..@@e.e....@e....e....
w...@e.@e..ee@e.e@ee@e@..e@e.......w
......e@e..@..e@e.e@@ee@e@.@e..ee...
..e.e.e@.e.ee.....eee@.ee@e..e@@@...
w.@e@..ee@e@@e...e@@ee@@e.@e.eeee@.w
..e.e@e@..e@e@e@e@@e@ee.@e@e.@...e..
..@....e..@e.@e...ee.@@ee@.@.e......
w.e@.@e@....ee@e@e@@@e.....e....e@.w
...e.e@.....@e.e@e@ee.e@ee@e.....e..