33,36
362
362
1000
...e@e.e@e.e@ee@e@.e.e@..ee.........
w.e@@e..e@.e@e.e.e.@e@eee@@@e......w
....e..@e...@e.@e@.e@@e@@eee...e@e..
.......e...@e@.e...@ee@@e.....e.....
w.......@e.eee....@eee.e...e..@e...w
...e@e.ee..e@@@ee@e@@@e@.e.@...e....
..e.e@e@..ee@ee.@e..e.@ee@@ee..@....
w.@e@@e..e@@ee..@e......e@e.@..e...w
..e..e@..e...@e.ee.e....e@e.ee.e....
........e@.......@e@e@e.....e@e@....
w..@ee..@@e@e@e.ee@e@..ee..e.....e.w
...e@@e.eee@e@e.@@e.@ee@@e@@e..e.@..
........e@e@....e...e@@ee@e@e@e@.e..
w.@e.e@.e@@e...@e...e@....e@eee@ee.w
..eeeeee.e.....e.....e....e@e@e@e@..
..e@@@e@.e@ee.@e.e@e..@e...@e..ee@..
w.@.e@@@ee@@@@e..e@...e....e.....e.w
..e..eeee.eeee@ee.ee.e.....@e.@e@@..
...e@e@.@e.@e.e@@e@@e@.@e.....e.ee..
w.e@....e@.e..e@e......e@ee@@e.....w
.....e@.e@e@.e@e.........@eee.......
..e@@ee.e@e@.@.@e........e@@e.ee.e..
w..ee....e.e.ee@....ee...e.ee.@@e@.w
....@e.....@e@.e....@@e@e@e@@eeee@..
...........e@ee.....e.@.e@.@e@...e..
w.e@e@e..e..e@@e.....ee..eee...e...w
....@e...@e.@e@@@e..e@e.e@@e@e@@e@..
..@e@......@e.eee..e@@e..e@e.eeeee..
w.e.e.....@e@e..@e.@ee...e@ee@..@e.w
..eee.....ee@@e@...e@.e..@e@e@ee....
..@@@ee@e...ee@eee@@..@.e@e....@ee..
w.ee..@e@@eee...@eee@.e..ee.e....@.w
...e@e@e.ee@@e.....@ee@.e@@e@....e..