33,36
362
362
1000
...e.@e..@e@e@.e..e...........e@e...
w.e@.ee@.e..ee@@..@e@e....@e..e@@..w
...e...e@...@.ee...e@e.e@ee....ee...
..e@e...e...e......e....e@e@e@e.....
w.@@ee....e@e.e...e@e..e@..e.e@e@..w
..eee@..e@@e..@...@e@..@ee@e..@ee...
........eee@@ee...e.ee.e@@e...e@....
w.e...e.@e.@e@..@e..@@ee@..........w
..@..e@e@e@ee...e.e@e@e.ee..........
..ee@e..e@@e@.e@@e@@e@@e@@..........
w......e@.e...@e@@.e.e...e...e@e...w
..@e...@e.@e@...ee.@e....ee...@e@...
..e.....e@e@e.e@.....e@e@@@...eee...
w...e@e.e@e@e..e@e.e...@eee.e@e@@..w
....@e@..e...e@e...@ee...ee@e@@ee...
....e..e@e@e.ee.@e.ee@e.e@@e.e@@@e..
w....@e@e@.@e@@@e@e@.e@ee@@e..ee@..w
..e.@e..ee..@eeee@...e@@eee@...ee...
..@eee.e@@.e@....e....e....@ee.@@...
w....@eeeee@e.e...@e......ee@@@ee..w
...e@@e@@e@@ee@..ee......e@@eeeeee..
....eee@e..e....e@@e@e........e@@@..
w....@@ee@e.ee@..eee@eee@e@ee@..ee.w
.....e....e.@@e..@..e@@ee..e@ee.....
...e@e..e.@ee.@..ee.@ee@@e@@.e@@e...
w..e...e@e@..ee..e@@ee@@e@ee...ee..w
...@e..e@ee.e@...@ee.@.e..e@.eee@e..
...@e..e@e.......e@@ee...eee@@@@e@..
w..e.e.e...@ee@e.e@e.....@@eeee@...w
...e.@.@@eee.e@e..e@ee..@e.e@@eee@..
..e@.e.ee@@ee....e@..@e.e@.@e...ee..
w.@e...ee...@e..e@e....e...@e@ee@..w
......e@@e.......e@...e@...ee@ee@e..