33,36
352
352
1000
..@e@e............@ee@e.....e@e..e..
w.e.....eee@@e....eeee@....@e@@.e@.w
........@@@ee.....e@@e@@e.ee.eeee@..
...@e...ee......@e....ee@e@ee@e@.e..
w..e.e..........e..@e......@@.@e...w
....e@....@e.@ee...ee@e.e..ee.e@....
...e@e@.e.e@.e@@e.@e..e@@..e.ee.e...
w.....e@@e...@e@@ee.e..ee@e@e@@e@e.w
..e@ee@e....e..e@e..@e..e@e.e@@ee@..
..@@e@@e.e.e@.@e@e.e@ee@e@e..ee.e@..
w.ee@@ee.@e...e..ee@e...@e@.@ee@@e.w
..@e.e.@e@e......@ee@e@e..e.e.@e....
..e@....ee@....e..@.e@..e.@..eee@e..
w.......@@e...e@@eee@..e@.eee@@@e..w
..e.....ee@ee.e@e.@e@eee@e@@e@ee@...
..@e.@e..e@@@e.e@.e...@e.e@e@.e@@e..
w..eee....eee@e@ee@eee@eeeee...@ee.w
..e@@e..........@e.@@ee@@@@@..@e@@..
..........@ee@ee...e@.@.eeee..e..e..
w.......e@e....@....e.e.e@@...e@e..w
..e....e..@e@e.e.....@e..@e.e.e@e...
..@ee.e@.e@e..e..e@e@e@..e@.@..@e...
w.e@@ee@e....e@e.....e@.e@e.eeee@..w
...@e@.e..e..e@@e@@e..ee@.@ee@@@@e..
..ee...@ee@e@@e@.ee.e@e@.....@eee...
w.@@e...@e..e..ee@@e..@....@ee.....w
..e@....e........e@e..e....e@.......
...e...e@.e.e@e..e@e@e..e......e....
w.....e@e.@e@.e...ee....@e@...e@e..w
..e@..@e@.e..e@@ee@@e..ee.e.e.e@@e..
..@e@eee@......e@@e...e@@e.e@.@e@e..
w.......ee....e.....e@.e@@e.....@e.w
....e@e@e@...e@......e@eee@.....e...