33,36
356
356
1000
......@eeee@....@e..eee..e@e....e...
w.@e..e.@@ee....e..e@@@....@....@e.w
..e.....e.@@ee@e...@eee....e@.e.....
.....e..e@e.@e@e@.@e..@e....e.@@e...
w....@e..e.@e@.ee.e@.e@@.....eeee@.w
......@.e@.ee..@@e...eee...e.@...e..
......e.@ee@@e.ee...e@@e@ee@.e..e@..
w..e@e.e@e@.e..e@ee.e@e.e@@@e@.....w
....e@..e...@e.e@@@ee@e...ee@.......
.....@e.e.......ee....@e...e@@ee@e..
w.e.@e.e@e@e...e@.ee@e@eee..ee@@e..w
..@eee@e.e@.....e@@eee.e@@..e@@e....
..@e@..e@ee....@ee@e@@...e....e.e@..
w.e.e.@e.@@e@..eee@eee@..e..e@e.@e.w
....@.e@.e..e..e@@.e@@ee.@e@e.@e@e..
..e.e@@ee.....e@@ee@.ee@.......e@e..
w.@e.ee@@e......e.@e@@e......e@....w
...e@ee@e.e.e@e@e@e.e.@e@e.ee@e.....
..e......e@..ee.....@e.e@ee@@e@.....
w.@...e@......@e...e@e.e@.e@e...e..w
..e@e..e....e.@e.@ee@e.ee@e.....@e..
...e@e@ee..e@.e..e@@e..@..e@e@e.e@..
w..@e...@e....@e.e@ee..e..@.e@e@...w
..e@.....ee......@ee@ee...e.e@@e....
...e..e.e@@e......e@.e@......ee.e@..
w..@.e@e.eee.e@....e@e@e....e@@eee.w
..ee..e@e@@@e.e..e@@e.e.....e@@e@e..
..@.e@e@@.e@@e.e.@ee@e@e.....eeee@..
w.e..e@ee..e.@.@e@e....@.....e@@e..w
..e@e@e@@e@e@e.ee@e@e..e...@e.@e@...
......e@@e@.e@e@ee@....@...e..e.....
w...@eeee.e.@e@.@e@ee..ee@e.ee.....w
....ee@e@e@..e@e...e@....e@e@@e.....