33,36
365
365
1000
......e@@e......@e.e@.ee..e@e.e@....
w..e@e.ee....e.ee.e@ee@@e.@e...e...w
....e@.ee@e..@e@e.@e.ee@.......@.e..
....@.e@@ee@e.e.ee...@@e....e@ee.@..
w...e.e@e..e@e@.@@...e...e@e..@e.e.w
..eee...e@e..e@.ee.....e.e@e.e@@.@..
..@@@e...e@e@ee......e@@e.....ee.e..
w.ee.................@ee@...e..e...w
...@ee@e.....ee@.e@e........@ee@.e..
..e@...e.....@ee@ee@ee...e@e@@...@..
w..e...@.....e@ee@@e.@e.ee@@eee..e.w
...e...e.e@e.e@@@e.e....@.e...@@e...
...@e.e.e@@e..ee@.e@e...e.ee..ee....
w.e@ee@..ee.....ee@.e@e.e@@@e@ee@e.w
.....e@ee@@@e....@@eeee..ee.....e@..
....@ee@@eee@.@e.ee@@@@..@e@e...e@..
w..ee@.....e@ee..@e.eee@e..e.e@..e.w
..e@e@...ee@.....e@...e@@ee@@ee..e..
..e@ee...@e@e@e.....e@eee@..e....@..
w..e@@..e.@e..e@e...@@e@@e@e@....e.w
.....e.e@e@@e@e....@eee.e...e@.e@...
....@eee@@e.@.@e@@eee.@e@@e.@e@ee...
w..ee.@@e...e@e.eee@@e@e@e@..e@ee..w
..e@@eee.....e@e....e@e......@e@@e..
....e@@@e....e@e..@e@e@...e@.e.ee@..
w.@ee@e......e@@e.e....e...e...@@e.w
..e....e....e.e@.@e@e..@e@.....ee...
...e@e@@e.@e@e.e.e@@e.e..e....ee....
w..e@eee@.eee@..e.eee.@e.@@ee.@@...w
..ee@....ee@@ee.@.@.@ee@@ee@@eee@...
..@ee...e@.e@e@.e.e..e@ee..e@ee.e...
w.ee....e@e@e@.e......e@@e@e.@@ee@.w
..e@...e@e....e@........ee@e.e@e.e..