33,36
361
361
1000
..e@e.e@e@ee..@e...e@@e...e@e.e.@e..
w...e.e@ee@@e.e@e@..ee@...e@e.@@e..w
...e@e@...e@e...@e...........@ee....
...@e@...ee.@e@e@e@...e.@e...e@@....
w.e@e@e..@@e..ee@@eeee@@e.@e@.eee@.w
....e@e.eee@....e.e@@..e.ee.ee@@ee..
..ee..e.@e....e.....e....@e..e@e@@..
w.@@..@ee@...e@.e.@e......e@....ee.w
..ee@e.@e.e@e@..@.ee@e.ee.@e.e@.@...
..e.ee@e@....ee@e@@@@e.@@eee.ee.e@..
w.@@e@......e@@e.eeee..e..@@e@e@ee.w
..ee........e@@e......e...ee........
..@.e@e..e@e.eee@e@eee@..e@e...e@e..
w.eee@e..e@e...@ee..@..e.e@@..e@...w
...@......@ee@.e@@e.e.e@e.ee@ee@.e..
..ee@.....e@.e.@.e.....e@e@ee.@ee@..
w.@ee...e.e..e@e.@e.e@e....@@e...e.w
..e..e..@e@..e.e@e@..e.e...e....e@..
..@e.@e.e....@e@...e@@e@............
w.@e..@e...........@eee..e...ee@e@.w
..ee@.e@.......e....@@@..@e..@ee@e..
....e.....@ee@e@.e@.eeee@e@..e@@e...
w.e@ee@e..e..eee@ee.e@.@e....e@....w
...ee@e..e@.e@@e..e@@ee@......ee....
..e@@e.....e@..e@e.e@@ee.......@@e..
w.@e.e@.e.e...e@....e.eeee@e.e@ee@.w
..e@.@ee@.@e......e..e@@@e@ee..e....
....e@ee@e.@@e@...@...@eee@@@e.@....
w......ee@eee.e@@ee..ee.@@ee...e@e.w
....e@e@.e@@e@.ee.e..@e.e..e...@.@..
..@e.....@e@ee..ee@.e@@e..e@e..e.e..
w.e@..ee@@e.e...@e@e.e@...@e.....e.w
.....e@.ee..@e@e.@e...e...e@e@e.e@..