33,36
351
351
1000
..@e..e@@e.e@ee..@ee....e.e@@e@e@e..
w.e...@ee@...@@..ee@e@ee@e@eee@....w
...........eeeee@e@@e@.@e.@e@ee.e...
....e@ee@..@@e@.e@.e@e.ee.e@e@@e@...
w.e@...ee..e.@e........@@e...e@@...w
..@e.e@@e........e@....e@e...@eeee..
...e@.e@.....e@eeee......@e..eee@@..
w...e..e.....e.e@@e....e@...e@@e.e.w
..e@e.e@.e.e.@.e@e..e..@e...........
..@e.e@.e@.@ee..e@e@@ee@e....ee@e...
w.@e@..@e@e@e..e..@e@..e@@e..@..@e.w
..e.e.@e@ee.eee@....e..@@e@..ee@@e..
......e.e@@e@@.e.....@eee..e@@eeee..
w.@ee@e@@e...e.@e....e..@e..e@..e@.w
..e..e@e.e..@e.e@..e.e@e.e..@e......
...e@ee..@e@ee@.@e.@ee@.e@@e........
w....e@..e@..ee.e..e@.eee@e.e@@ee..w
..e....e.@...@ee@..@e.e@..e@@ee.@e..
..@ee.e@.e@.@e.....@e.e@e..ee@..e@..
w.ee@@eeeee.e@.@e@@e..@.@e..e@e@@..w
..@e@e@@@@...@eeeee.e@e.e@e@e@.ee...
.......eee...e.@@...e@ee@ee.@e@@@e..
w.@ee..e@....@eeee@e@e@.e@@e..ee@..w
..ee@e@...e@e@e..@e..e@ee@e.....e...
.....@ee@.e@e........e@e.e@....e@...
w.e@ee@.e@e@e...e@@e.....e@ee......w
..e@...e.e@@e.e.eee.e@e....e@.e..e..
...e@..@e..ee@@e@.@e@@e......e@.e@..
w...e........e...e@e@e..e@e..e@e...w
....e........@..e..e.e@.e..e.@e.....
...e@..e..e@ee..@e.@e.e.@.e@.e@.....
w.e...e@..@e@@..........e.e........w
..@e..e@e....e@e.........e@...e@e...