33,36
359
359
1000
...ee@e.e@e@e...........@e.e@e......
w..@e...e@e.@e.e@e...@e.e...e@e.e@.w
....e@.ee@e.e@e@e....e..e@.e..@e.e..
.....e.@e..e@e..@e.e@e@.@e.@...@....
w.....e@@e..e@ee@e@.@ee.e..e...eee.w
......@ee@..@...e@e.e...@e..e..@@@..
..e@.e@@...@e..ee..........e@@eeee..
w.ee@eee@e@ee@e@@e....e@e.ee.ee@...w
..@@@e@@@e...e@...e..e....@@e...e...
..eee@@eee...@e.ee@..@..e.e@e..e@...
w.....e.e@.e.e@.@@e..e.e@..e@..e@e.w
..@e..e.@e.@e.e.e..e@@ee@.e@e@e@....
..e..e@e@@e@..@ee..ee...eee......e..
w.@e.e@@e.ee....@.e@@...@@@.....e@.w
..e@.@e@@e@.@e..ee@ee@..eee.e...e@..
...@ee.e@@@ee....@@e.e@e@ee.@e...e..
w..e@@e.eeee@e...ee@..@ee@@e@....@.w
..e.ee@.e...e@@e.@e@..ee@@e.ee...e..
..@e@..e@e@ee@e....ee@e@.e...@e.....
w..@@ee.ee@e.....ee...e.@e....e@e..w
...ee.@e@.e@....e@@e@e@.e...........
......ee@e@.@e@e..e@e...e....e@.....
w.@ee...ee.ee..e@e@.....@e....e@@e.w
..e@@eee@@e@..e.e@..@e...@e....eee..
...e@e@@eee@ee@ee@e@e...e...e@e.@@..
w.e.e@e.....ee@@@e..@eee@e@ee@.eee.w
..@e@.@ee...@.ee@@....@e.@.@ee@@e@..
..e..e..@e.ee...ee...e...e..e.ee.e..
w.@..@e.@ee@@e@e...@e@.....e@..@e@.w
..ee.e@.ee@@e.....eee@....e..e......
...@e...ee.e...e.e@..e..e@@ee@e.....
w..e@..e@@e.e..@e.eee@...e....@ee..w
...e@e....@e@..e@e@@e.........e@@e..