33,36
359
359
1000
..e...@e..........e@.......e@.e@e...
w.@e..e@....e.e...@e.e@@e...ee...e.w
..@e....ee.e@.@.......ee..e..@eee@..
..e@...e@@...eeeee@e......@e.@e@....
w..e....@ee@e@@@@e@e.ee...e@.e..e..w
..e@....e...@.eeee@e@@@e...e@e..@e..
..e@.......@e.......ee@....e@e..e@..
w..e....e@ee@....e.e@.e....e@...e@.w
...ee@ee@e@..e...@e...e@.@e.e@.e.e..
...@e.e@.e...@@ee...e@@e.e..@e.@e...
w.e@@..e@@ee.eee@@e.@ee.@e@e@e@e...w
..@eee..e.@@e....e.e@.e@eeeee@@e.e..
...e@@....e@e.......ee..e@e@@@e@.@..
w....e..e..e..ee.e.e@@e.e@@@ee...e.w
...e@.e@@..@e.@@e@.@e@@e@eee..e.....
...ee..ee.e@.@e@e..e.ee@@e..e.@e@e..
w..@e......e.e.@e...e@@.e...@.e.e@.w
.......e.e..e@ee@@e@e@e..e..ee@@e...
.....@e@e@e@e@@@ee.e..e..@e@e@ee@...
w....ee@@e.e.ee..e@e.e@e@e@.e.@....w
..e@e@.e...@.@e......ee@..@e@.e.ee..
..e@.....e@e.e@.@e..e@@@e.e.e.e@@@..
w..e@.......eee@e...@.ee....@e.eee.w
...@e......e@@.@e@e.e...e.e.e@..e@..
..e....e.e...e.e....ee..@e@...@ee@..
w.@e.@e@e@ee@e..e@ee@@e@@e.eeee@.e.w
...e.e.e@@ee@eee@@e.@eeee@e@@@e..@..
..e@.@e.@e.e@e@.@e..ee@.e@@ee@...e..
w.@..e@.e..e@.@ee..e....@e@e@e..@e.w
..e...e@....e.e.ee@@e.e..e@e....ee..
..@e..@e...e...e@.e@ee@.e@e....e@@..
w.e....@...@ee@@...eee@e.e@e.....e.w
..@e@e.e..e@e.ee..e@@e@e.@e.........