33,36
360
360
1000
......e@e@e..e..e@.e@.ee@e.e..e@e@..
w..ee@ee.e@.e@e..e.ee.@e...@e.ee.e.w
...@@e@@e....e@..ee@.e.....e@e@@e...
..@ee........e...@e..@e...@ee@@e@...
w.e.@e@e.e.ee@...e@e...e@ee.@@e.e..w
...e@eee@@e@....e@.@e...ee@eeee@@e..
...@..@@e.....e@@@e.e@e.@@ee..@e@@..
w..e..e.......eeee.ee@e.e@@@....ee.w
.......e.....e@....@.@e.eeee...e.e..
......e@........ee@e.e..@ee@..e@e@..
w.....e@....e...@e.e.@.e@e@@e@e@e@.w
...e@e.e...e@..e@e.@ee.e@@eee..e.e..
..e@............e@.e@@e.e@..@e@e@...
w.@..e@.......e@e...ee@.@e....e.e..w
..e...e......e@@e...@@@e..@e.e@e....
..@...@...ee..@e@e..eee@e.e..e@@....
w.e...e.e@@@e.e..@ee@@e.@ee@e.ee...w
......@..ee@@e.e@e@@......e@@e@.e...
......e.e..ee..@ee@e@e.....e@@ee@...
w..e.e@e@ee@@.e@@e@e...e@e.eee@e@..w
..e@.@ee@@e.e..ee....ee@ee@@@@..e...
..e@....e@e@e@e...e..@@e@.eeee...e..
w.@e..e@@eee....e.@@eeee@.......e@.w
..e@...ee@@@e...@eee@...e.....e@@e..
..e@@e.@.ee........@e.....e.@e.ee...
w..eee.e.@@..@e...e.@.ee.e@.e@..e@.w
..e@@@.@eee..ee.ee@.e.@@e....e...e..
....ee....@.e@@e@@@e..e.eee@e@e@ee..
w.e@.e....eee@e@eee....e@@e@ee@.e@.w
..@ee@e.e@e@@e.e@......eeee@ee@@e@..
..@e@.@e....@e.e....eee@@@e@e.ee.e..
w.e....e@...e.e@e@ee@@e@e...e@.e@e.w
........e..........@e.e@e....e.e@e..