33,36
359
359
1000
....e@ee..e.e@.e@e.e@.....e@e.e@e...
w.e.@e@@e.@.@e@e..e.e.e..e...e@@e..w
..@e.....@e...e@e@@e..@ee@.e@@ee....
....e@e..e@e.@e..e@...ee@@e.ee@e....
w.........e@.e....e@e@@@ee....e@e..w
...e@....e@.....e.@e.ee@ee@e@e@.e@..
..eee@e..@e.e...@e....e@@...ee@e.e..
w.@@@..@e...@ee...e.@e.eee..@......w
..eeee.ee.ee@@@e..@.e.e@e@..ee@..e..
..e@@@e.@e@@ee@e@.e......@e@..e@e@..
w.e.ee.e@e.e@...e@e.e@...e.e@..e...w
..@e@@.e@e@e@@e..e.e.ee@.e..e.e.e...
.....ee....@ee..e@.@e.@e@@...e@e@e..
w.e@@e@....e.@...@e.e@e.ee.e@e@@e@.w
...ee@@e..e@.e.e@e...@e....e@eee....
....e@e.e@..e@e....e.eee@e.......e..
w..e@e.e.ee@e.@@e..@e@@ee@@ee...e@.w
..e@e..@e.e@e@ee.e@...@ee.e@@e.ee@..
...e@.e....ee..@e@e.e@e.@e.e@e@@@e..
w....e@e@..e@@ee@e..@e........ee...w
..@e.@e@e...@ee@e@@e..e@e.@e..@e....
..e.....e..ee@....e@@e....ee@e@ee...
w.......@ee@@e.....@e.......e...@e.w
...e...e@e.e@@e....e.ee...ee@@e.....
...@e@ee@@..e@.....ee@@...@@ee..@e..
w.e@e...ee..@e..e..@e@e...e.@eeee..w
........@e..e@..@.@ee@.e@e..e@@@@e..
......e@e..e@@e.e.e..e...e....ee....
w.e@e.e@e....e@.@e....e@e@..e@..e..w
..e@@....e@ee@....ee...e.....e.e@...
..@ee..e.e@....eee@@e@e@e......e@e..
w..@..e@e@e.e..@@.e@@ee@@ee@e@e.e@.w
...e.e@.@e.e@..ee..e...e..e@e..e@...