33,36
369
369
1000
..@e..e@e.ee@e.e@@ee@e@ee.e..ee.e@..
w.e...@@ee@.e@eeee@.e.e@@e@.e@@eee.w
......ee.@..e@@@ee@ee@...e@e.@e.@e..
..e..e..ee...ee..@e@ee..ee@e.e...e..
w.@ee@ee@@.......ee@@@e.@ee@.....@.w
..@e.e@@@e.e@....@eee............e..
..e....ee..ee...@e.e@.....ee@e...@..
w.e@e.e...e@...ee@..e...ee@..@e@ee.w
...@e.@e.e@.@ee@...e@e@.@.@eee...@..
...ee@e@....ee@e..e@eee.e.e.@...@e..
w...e@......ee@@...e@@@....ee.e.ee.w
..e..e@e@e.e@.ee....eee.e..@ee@.e@..
..@e.@@e.@e.@e......@e..@e@.e..e@e..
w.e@@eee..@@ee@e.....e...eee@..@...w
..e.e..@e.ee.@e.e@e..@...@.....ee@..
..@e@.@e@e....@@e..@ee.e@e.@e.e..e..
w.@e@.e..@e.@eee@..e@..e@@ee@.@e...w
..e.e.......e..e@.......e.ee@ee@@e..
...ee.eee@ee@e@ee.@e......@e@@e@e...
w.e@@e@@e@@..e@e@.e....e@e@.ee..@e.w
...ee...@eee..ee......e@@eee........
..e@ee...@e@.e@@.@e@e..@eee@..e@....
w.@ee@e.e@.@ee@e.e.....ee@@e@e.ee@.w
...e@e@@ee.e.........e@e...e@e...e..
...@e..e@....e@ee@e@.......ee@e@e@..
w.e@.e@e....@e.e@@ee.......@e.@ee@.w
...e.e@e....e.ee@e....e@ee..e.e@.e..
.....@@e.e@e..@e...e@e..@@e.@e@.e@..
w....eee@e@e@e@e.e@.e@e@ee@e....e@.w
...e..@.e.e@@e...@e.@e@@e@.@e..e.e..
..e@.@e...e.e..e@e.....e..e@@e.@e@..
w.@..e...e@e.ee@@eee.......e.......w
..e.....e@e.e@e@ee@@e.e@e...........