33,36
361
361
1000
..e..e@e....e@e@ee@eee@....e.e.e....
w.@e@e@@...e@ee@ee@e@.e...e@e@.@@e.w
......ee..e@e.e....e@eee..@ee@eee@..
.......@e@e.@.@ee..@@e@@.e@ee@e.@e..
w......e@...e.@e@e.ee.@e....e.ee@e.w
............e@e..@e..ee@...e@.@e....
....e..e@e.e......@e.@...@e.@ee@....
w...@e@@@e.@e..e..@eee...ee@e@.e...w
..e...eee.....e@..e.@e@@e..e...@e...
..@eeee@@..e@ee@e@e.@eee.e.@e.e@e...
w.@e@@e@e.eee@e@ee@.ee@@e@e@@e@....w
..ee@e@e..@@.@e..@.e@e@ee.@ee@......
...@ee@@..ee.e@..e@@.e@e@@ee@.......
w.e@eeee@e@ee.....ee.@e..e.....@e..w
..@ee@e@..e@@.ee@e...@e.....e@ee....
...e@.e@e...ee@..e@e.e...e..e@...e..
w...e.e@@e@.e....@e@.@..e@...eeee@.w
..e.@..e..e.@e.e.ee@.e@.ee@e..@@e...
..@.e..e@ee...e@...ee@ee@.....ee@e..
w.e...e..e@.e@e@...@@ee@e@.@e.e.e@.w
..@e..@ee@.....e...eee@@ee.e..@.e@..
...........e..@e.@e.@e.e......e@ee..
w.........e@..e.ee..e.....e...@..e.w
......e@....ee.e@@.e@.....@@e@ee@@..
..e@...e...e@@e.@e..@e.@e@ee@.@eee..
w..e@e.....e@e@.e...e@.e@e.@...@e@.w
...e@.e.....e.....e@e..e@@ee....e@..
....e@@@e..e..ee....@eeee@...e@..e..
w....eee...@e.@@..ee..@@ee..eeee@@.w
...ee@@.e..@e.eee.@@e.e..e.e@@e.ee..
...@e.e.@e@e.e@e@.e@.....@e.e@e@e...
w.e@@....e@@e@@ee..e...@e@e@@ee@e..w
...ee.e@e.e...e.@e@e...e@e.e........