33,36
360
360
1000
..........e@ee@e@ee@e......ee...e...
w...e.@e..@ee@ee.e@@e..e.e.@@e.e@..w
..e@@ee...@e@.e@.e@e...@.@ee...@....
...e@.@e..ee..e@...ee.@e@e.e@e.e....
w.e.ee@@e..@e..e...@@.e.e@...e.e@e.w
..@...e.....@@e@...ee.@e.....@eee@..
..e.....e@e@ee@.........@eee@@e@.e..
w.......@e@...e@ee@..e@eee@.ee@.e@.w
..........e@.e@ee@e..@ee.e.e.e@.e@..
..e@e......ee@@e@...e.e@e@.@e.ee@e..
w...e@...e..e@e...e@@.e@@e@e.e@@e..w
....@e...@ee@@e..e@ee.@ee.....e.@e..
...@e.e@ee.eeee@e@...e@......e@e@e..
w..e...e@@e@@e.e..@e.@e....e@e@@@e.w
...ee@e....e@e....e.e.e......@eee...
..e@@e....e@.....ee@@e@.....e@@.e...
w.e@e@.........e.@@e@e..e@..@eee@e.w
..@e.....@e@e.e@.e..e@...eee@..@e...
......e..e..@.@@e.e@@e...e@ee@......
w...e.@e..e@e.ee...e.....@e@@e.e...w
...e@....e.e...e@e...e...ee@e..@ee..
...@e...e@e..e@@...ee@e@..@e@e@@e@..
w.@e...e@e@...ee..e@@e.e....e.eee@.w
..e...e@@ee@....@e.e.ee@...e@....e..
....e@@ee.eee@e@e.e@e@e@..e@@e...e..
w....e@e.e@eee@....@e.eee@@ee...e@.w
..e..@e@e@.e@@e.e..e.e@.@e@.ee......
..@e.ee@eee.e@@.@e....e.@eee@@..e@..
w.@ee@@e.@@.@eee@@e@..@ee@@eee@e.e.w
..e..e@e@ee.....e@eee....ee@@e@e....
...e@@e@........@..e@....@@eee@e....
w...e.e@e.ee....ee@e@eee.e.e..e....w
.....e@e.e@@e..e@e@e.e@@e.e@.e@.....