33,36
362
362
1000
..@e...e@ee@e.e@e...........e.......
w.e.e@e.e.@@e@..@e...e@e...e@e...e.w
...@e.@e.eee.ee@eee@e....e@e@@e@e@..
...ee...e@@...@e.@e@e@...e..e..@e...
w...@...e.e.eee@ee@.@e...@.....e...w
..e.e...@e@.@@ee@..@e..@eee@e@ee....
..@ee@e@e...e@ee...ee..e..e@e..@.e..
w.ee@ee.e@@e.e@@e...@...e.e@@e.e.@.w
..@e.@@e.ee...e@e.e.e..e@..e@eee@e..
....@e..e@...@e.ee@.....e.ee@e@.....
w..@e...@e...e..@e@.....@.@..e@e...w
..@e@.e@@e......eee.....e@e..@@e....
..ee..eee.......e@@ee..ee.@e.ee@e...
w.@@.e@e@..e@e......@e.@@.....e@@e.w
..ee...e@e.@e......e@@eee.eeee@e@@..
...eee@e..e@@..e....ee@@ee@@@@e.ee..
w.e@@..e.e.ee@e@..e@ee@e.e@ee...e@.w
....e.e@.@e.e@e@e.@e.@e@...e@...@...
.............ee@e...e@e...@e.@eee...
w.ee.......ee@..e@.e.@e...e@.ee@@e.w
..@@@ee@e.e@@e..@e.@eee@e@e..e@@e...
..eee.e....e@.ee..e@e.e.e@e@...e@...
w.....@e@...e@@@@e.e@.@@e@.e..e.e..w
.....e@ee....eeeee....ee.e.e@e@.@e..
..@e..@e@..@e@e..@.......@e..e@e....
w.e...e.e..ee.@e.e@e.........e@e.e.w
..e..ee@@ee@@e....e@@ee......e@..@..
..@.e@@e@.e@.....e@@ee@.@e.e@.e..e..
w.e@e@e.e..e...e..ee@.@ee...ee@....w
..ee...........@e@@e@ee@e@ee@@ee@e..
..@e....e..e@...@eee@ee@@....@e@e@..
w...e@e@@e@@e..ee@@@e.@ee.e.ee..e@.w
....e@ee..e....@e.ee@.....@e@@e@ee..