33,36
357
357
1000
...e....e@e.e..e@e....e@ee@e.e@.....
w..@....e@ee@e@e@e.e..@e@.....e....w
...e.@e..e@@.@ee@.e@e.ee@.......e...
.....e....@e@e..e@@e@e@.e@.e@e.e@...
w.....ee..e......e@..@e@ee@e...@e@.w
.....e@@e...e@@ee.ee@e...@.....e.e..
.......e@..e@ee@@..@ee@e.e@...ee@...
w......e@ee@@ee@ee...@@e..e.e.@.ee.w
...@e@.e....e....@e..ee@e.@e@eeee@..
...e.ee@e..ee..e@ee@....@.e@e@@@ee..
w.e@..@..ee@@e..e@.e.e@.ee@e..e.e@.w
..@@e.e.e@@e@.....@e@.e.e@..........
..ee....@...e..@eee.e@e..@e@.e.ee...
w....e..e......ee@@.e@ee.e.ee@e@@e.w
..ee@@e....e..e@@ee@ee@@e..@ee@@e...
..@@e.@e.ee@..@e.e@@e@e@e.e....e@e..
w.e...@ee@e..e@ee..e@.e@e.@e.....@.w
....e@e.@ee@...e@e....e@e....eee.e..
.....e@e@e.e...ee@e@e......e@@@@....
w.....e..e....e@@e..e..ee@.eeeee.e.w
..e..e@e@@...e@ee..e@e.@.ee@..@@e@..
..@ee.@eee...@e@@e.@e..e.ee@..e.....
w...@.e.@e@e@e.e@@eee....@ee@e..@e.w
....e...e.e@@e@.e@e@@e@e@e@@.e@ee...
...e@e.e@.e.e.e.@ee@....e..e@e@..e..
w..@e@..e@@@e@..e..e@e...e@e@.e.e@.w
.........eeeee..@e@.......e.e@e.....
.....e@..@@e@@e.@eee......@e.....e..
w.@e..e..ee....ee..@.e.@e..@e@e.e@.w
..e@....e@....e@e@ee.@@e@e.e@e@@e@..
.....@e.e@e....e@e...eee@@@e@e@e.e..
w....e@.e@...e@@......e.eee..e@@.e.w
........@e...@ee.e@e.e@......@eee@..