33,36
360
360
1000
..@e@e@.e...ee.....e@ee@e.e@e@e.@e..
w.e.eee@@e..@@.@e@e...@e@.@e....e..w
...e.@ee.@e@ee.ee@e........e@e......
..e@e@ee@@ee@e@.ee@.....e.e..@.e@...
w.@e@@e.eee@@eee@@@e..e.@e@eee..e..w
..e..e....@@e...eee@e@@e@@e@@.@e....
..e..e@...ee...e@@@e.e@.e@eee.e.....
w.@e..e@.....e@e.e.e@eee.e@@@e@.e..w
..e...@e.@ee..ee.e@@eee@.e@e.ee.@...
..@e@....e@@ee@@e@ee@@@e.e@.e@@ee...
w.e.e..e@ee@e.e@@@e..e@e@@ee@e..@e.w
..@e...e@@e@...eee@.e.@eee.e@@e.....
..e.....ee@e....eee.@ee..@e@ee@..e..
w.@...e.........@@@e.e@.e@e@....e@.w
..ee@e@........@ee......@@ee........
..@@ee@e@@e....e......e@eee.........
w.e..@e@ee............@@e.@e@......w
......................ee..e.ee......
..ee@..e....e...e@e...e.e@..e@......
w.@ee..@.eee@e@e..ee@e@.@eeee@e..e.w
.......e.@@@ee@e..@....ee@@@.e.e@@..
........eee..@e@e.e...e@@.ee.@e.ee..
w.e.e..e@ee@.e.e@.......e.....e@e@.w
..@e@e@e.@ee.@e.e@.e....@..ee@e..e..
....e@@e@.@e.e@..e.@e...e.e@.e..e@..
w...e.e.ee.@@ee...e@e..e@....@e@e@.w
..e@@e@ee@.eee@@e............ee@ee..
..@ee..@@@e@.@eeee@eee@e.e...@@e@@..
w.ee.e@eee..@e@.@eee@e..e@ee@e...e.w
..e@........e...e@@e.@ee@.@e@@.e@@..
..@e..e@@e@e.e....ee...@@eeeeee.ee..
w......ee....@....@@e..ee..@e@@e...w
.........e@e.ee@e.e@e.........e@....