33,36
355
355
1000
..e..........e@e.e.e@.e@.e@e@e......
w.@ee........e@@e@..e@ee..e.e......w
..e.@.e@ee@e@@e@@e..e@e..e..@ee..e..
..@ee..e@e@ee..e.@e..e@e@@@e.@@e@@..
w......e@e@e...e..@e....eee.ee@eee.w
......e@e@ee@.e@.......e@@ee@.......
..e...@@e.@.e@e.........e@@@ee@.....
w.@..@ee.@e@@ee..........eee@@e....w
..e..e...e.e..@ee...........@e.ee...
..@e..e@..e@e..e@@e....@ee..e@.@@e..
w.....@e...e@.e.@e.....e@@e.ee@ee@.w
...@eee...e@..@.e@...e....e@@e...e..
...ee@@...e@e@e....e@@@ee@ee.@..e@..
w.e@..e.e@..e@e@e@e.eeeee@...e@ee@.w
..e......e@.e@...e@...e@.e.e.e@..e..
..@ee@....e@@e............e@..e@e@..
w..@eee....e....ee@e.e@e@e@........w
....e@@e..e.....@ee.e.e@e@.....@e...
..ee@e@...@ee@ee@.@e@.e@e.ee...ee@..
w.@...e.....@e@.ee@e.e@e@e@@e.eeee.w
..e@e@e..........@....ee@@e..e@@@e..
...ee@...@e......e.e.e@.ee@.e@.ee@..
w.e..ee@ee..@e.e@ee@e@@e.e@eee.e@..w
..@e.@ee.@e.e..e@..e@@e..e..@@.e....
..@e..e@e...@.e@e....e...@..ee.@ee..
w.e..e@e@e.eee@@e@e..e@e.e..e@ee@@.w
..@e.e@e.@e@.e@e@e@e@@e..e@.@e.@ee..
.....e@@e@e@ee@.ee.@e@e..@e@eee@e...
w..e@.e@.e....ee@@e.e.e...e@.@e....w
....e.@e......ee@.e.@e@.@e.e..@ee@..
..e@@e.@e@e...@.e.@e@...e.....@e.e..
w.@e@..ee.e.e.e.ee..e..e.e@e..e@...w
....e.e@@e@.@e.e@@e.@ee@......e@e...