33,36
352
352
1000
....e@e@e.e@@e...@e.........e@......
w...@@e@e..ee....e..e..e.@e..e@ee..w
....eee....e.e@e.@ee@..@.e.e.@e@@...
...@e.@e.e.@e@@eee@....e...@...@e...
w..e.....@.e@ee@@eeee@e@...e...ee..w
..e...eeeee@.e...e@@@e..e@e.e..e@...
..@.e@@@@...e@.....e.@e@@e.e@...@e..
w.e.@eeee...e@.......e.e....@ee@e..w
........@.@e.e..e@..e@e.....ee@e....
..e.....e.e@.....e.e@@e.......e@e...
w.@ee...e@e@e..@e...@e........e@@e.w
..@e@...e@e@e..e...ee..e@ee@e@@ee@..
..eee.e@..e@...@e.e@e.e.@e..@e.@e@..
w.e@@e.e...ee.@e@e@e@.@.e......@ee.w
..e@e@.e@e@e@.eee@e...e........e@...
..@ee@e@ee@@.e@@@e@ee@e....ee@e@....
w....e@@e.ee.@eee..@@e..e@e@e@ee...w
....e@.ee@.e@e.....e.@....@.e@@@e...
...ee..@@e..e@e@e.e@ee@e@@ee.ee.....
w.e@@e.e.e...e.e....@ee.ee.@..@ee@.w
...e@..@e@.e@@.@.@e..@@e@..e.e@e.e..
..@ee@eee@e.ee.e@e...e@....e.e@@e@..
w.e.e@e@@@eee..e@ee..@ee...@e@e@e@.w
..@e...eeee@@e@e..@e...@e.....e@ee..
....e..@e.e@e.e@...e@e....@e..@..@..
w..e@e.e..e@@..e.e@e@e....e.eeee@e.w
....e@.@e@@ee@e@.@e...eee..e@@.ee...
..e......e@..ee@e....e@@@e...e.@@e..
w.@e......e..@...e....@e...e@..e@..w
..e@e...@e@e.e..e@....e..@e@e..@e...
...e@e@ee.e@......e@....@e..e@e.....
w..e@@e...ee@..ee.@e..e.e...e@@ee..w
....e....e@@e.e@@e@e..@e.....ee@@e..