33,36
343
343
1000
..@e....e.......e@e...e@e..e..e@e...
w.e.e@..@e@e.ee.......e@@ee@.ee.e@.w
....@e@e@@e@.@@@e@ee.e@e@eeee@@.@e..
..@e@e..e....eeeee@@.@....@@@ee.@e..
w.e@e...@....e@e@..eeee@e.ee@e@.e..w
....@e..e.....e@...e@.e@e.@ee@.e@...
.....@.e@....e@..e....@.....@.e.....
w....e@......@e@e@e@..eeee..ee@.@e.w
......ee.e@@e......e@ee@@@e.@e..ee..
.....e@@..ee.....e......e....e@e.@..
w.....ee........e@e@ee@e..e@.....e.w
...e@e@e@.e@e.ee.e@..e....@ee@e..e..
..e@..e.e@...e@@e@e..@.e.e@ee@e.e@..
w.@@e.@@ee....@ee.@e.e.@e@@e@e.e...w
..ee@.ee.e.ee.ee@@e.......e..@e@....
..@e...@e@e@@e.e@e...ee...e@ee@.....
w...@e.ee@@e...@e....@@e.e@@e@.....w
..@ee@...ee@..e@e..e.e.e@e@e@.......
..e@.@e.....ee@e@..@e@e@............
w....e..e..e@e@.e..eee.......e.e@e.w
...e...e@..e.@ee@@e@@@.e@ee@.@..e@..
..e@e@e@.ee@ee@.@e@.eee.e@@e@e..e@..
w.@e.ee@e@@.e.e@e....@@@e.......@e.w
..@e@ee...ee@.e@e....eee@e@eeee@ee..
..eee@@e...@ee.@e.......e@e@@@@e.@..
w..@@....e..@@ee.@e.........eee.ee.w
...eee@..@e@e@e.@e..........e@@e@e..
......ee.e...@e.e....e@e..@ee@e..@..
w......@.....e..@e...e@..ee@@e...e.w
..e.e@.e@e..e@..e@e@e.e@e@@e........
..@..e@e....@e.e@....e@.e@@e..e.....
w.e.e.@e..ee@@ee@e.e.e...ee@.e@..e.w
....@ee@.e@.e...e@.@e@...e@.....e@..