33,36
347
347
1000
..ee..e@e@e.@ee.......e@e@..e@e@@e..
w.@@e@e@e@@ee.@.......@@ee..ee.ee..w
..e@ee@e.e..e.e.......ee...e@e@eee..
..e@e..@.@..@.........eeee.e.e@@@@..
w..e..eeee@ee..e@e.e@e@@@@e@..eeee.w
...@e.@.@.e@@@ee@e.e@@.eee@.........
......e@e...ee.@e@@eee..@e..........
w...........ee....e.ee@.e@e@e..e...w
...........e@@e@@e.e@.ee@e@e..e@....
..e@...@e...e@.ee@..@e.@.e@@@eee....
w.ee...ee@...e.@eeeee..e..eee@@@...w
..@@e....ee@e...e@@@@e........ee@e..
..e...e@.e@@e.....ee....ee..@e@.e@..
w.....@e.@eee@e@.@e....e@@e.e...e@.w
...e@e...e@.@e.e@e...e@e.e@......e..
........e...e....@.@e@...e@e...e@@..
w.e.....@e..@.@e@e.e..ee.ee.e.e.ee.w
..@e....e@e.e.e....@ee@@e@@e@e@@e@..
..@e......@........e@@..@ee@e.@e@...
w.e.....e@e.e...@e..@e..ee@e@@ee...w
..e@ee@.e@e.@e@ee.e.e@..e@ee@e.@....
......e@e@ee@eee.e@.@..e..@.@e.e....
w.....ee@.@.e.@@e@@ee..@e@eee.e@...w
.....e@...ee@.e@eee....e@..@e.e.....
..e@...@e..e....e@@e@e.@@e@eee@e@...
w.@e...e..e@.@e.e@e.e@.eee@e@@e@e..w
..@e...@.@ee@ee.e@..e@e..@e..e..@e..
..e..e@e@e...e@.ee@..@e@.....@..e@..
w.ee@e@........e@@ee@e.e..e..e..e@.w
..@@..e.e@e.ee@....@e.e@e@@e.....e..
..ee...e@.e.@ee.......@..ee@@e...@..
w.@@..ee.e@e@@e@e@e..@e@ee@@e....e.w
..ee.e@@e@..e@e......e.....e........