33,36
363
363
1000
..@e@@e@e..e@@e........@e.......ee..
w.e.ee...e..eee....e@eee...ee@e.@@.w
........e@....@....e.e@...e@@e@.ee..
....e....e@e@.e@e.e@@e..e@@e.e@.....
w..e@@e@e@e.eee@@...ee@e.ee@..e.e..w
..e@@e...e..e@eeee...e@e@e.@e.e@@e..
..e@e@..e@e@@@eee@ee@e@e@e@e..ee....
w...e@ee...eeee@@@e.ee@e...e@.@.@e.w
..ee..e@@e@.....ee.e@e@e....e.e@e@..
..@@.e@@e.e....e.......@..e@e@@e.e..
w.ee...e.....e@@e..e...e@..eee@ee@.w
..@.......e...e@ee@@ee@ee@e@@@e@e@..
..ee@....e@.ee..@ee.@e@@....e@...e..
w..@ee.....e@@ee@e..@eee@.ee.e..e..w
...ee@@eee......e...e...e.@@e...@e..
..e@@ee@@@e..e@e@......@e.e@....e@..
w.@e....e@e..e@e@e@ee..e...e.....e.w
..@ee..e@@e...ee...@@eee@.e......@..
..ee@..e.e@..e@@...e@@@@ee@e@e@..e..
w..e@ee@.@e@e.@ee...eee..e@ee.e@...w
...e@e.@ee..@ee.@.e..e@.@e.e@e.ee@..
..e@e@@e....e@..ee@....ee..e@@e..e..
w.e@e.ee.e..@ee@e@e@.e@@@.e@e...e..w
..@e.e@@e@e@e@.e.e.e..eeee@....e@...
..e@.e@.eee@.e@e.@e......@e....e....
w.e@e@ee@@ee...@e........e@....@ee.w
...e@@ee@..eee..........e.@e@.@e@@..
.....e@.e..@@@.....e.ee@@.e@eee..e..
w..e....e@.eeee.e..@e@@ee..e@@ee@e.w
..e@e..@ee@e.@@e@...e.....e@...@....
..@e.e@e.....ee@e.e.@e..e@@e...eee..
w.......e...e@e@@e@...e..e.....@@@.w
.......e@......e...e@e@........eee..