33,36
365
365
1000
..e@e..ee@@e.....@e@@e@e.e@e@e..e@..
w..e@.e@@ee......e.ee.e@..e....e.e.w
..e@@e@e..........@e@e@@e.e@...@e...
..e@e.e@......e.e.e....e...e.e.@e...
w.e@e....e@ee@@.@@ee@......ee@.e...w
..e@@..e@@@e.ee.ee@.e.e....@e@.@e...
...ee@e@eeeee@..e@e...@e@.e..ee@e...
w.....e...e@@e..@e@.e@..ee@e.......w
...ee@@e....e@.e@e..@e..e@e@....e...
..e@.e@e.......@e@@e@e..e@e@....@e..
w..e@@e...e.@e.e..e.....e@ee.....e.w
...@e@e..e@eee...e@.e....e.@.....@..
...e....e@..e@...@ee@@ee@@ee..ee.e..
w..@ee@e.e@..e@ee@...e.ee.e@.e@@e..w
.....e@e.@eee@@e@e.ee..@..@@ee@@ee..
....e.e@.ee@@ee....@@e.e..ee@.eee@..
w.e.@e@.e@@e@...e..e...eeee.e@ee@..w
..@.ee@e....ee@e@...e@e@@@@e..e.e...
..e..@e..e.e@e@@eee.e@e.ee.@e@@e....
w.@e..@.e@....e.e@@.e@e....e.e@e...w
..e@..e........e.@ee@.e.e..e@@e@....
..ee..@e@..e@ee@.e....@e@eeeee......
w.@@eee@ee@...@e.@e@e.e.e@@@.....e.w
..e..@e@e@e.e.ee....e@e.e@ee@e.ee@..
..@e..@e...e@e@@...e@.@e......e@@e..
w..ee.e@e.e@@e@e@@e.ee@e....ee@....w
..e@@e..@e..e...ee..@e..e...@e.ee...
....@e.ee...e@e@ee@e@e.e@..e@..@@...
w.e.e..@@ee..e@.@..e@@e.e@e@e..ee..w
..@e...e@@@e@e..e...e.e@e.e@eee.@e..
...e@.e.ee@e.e.ee.....@e.e@@e@@@e...
w...ee@e...@e@.@@........@.e@.eee..w
......e@....e@eee........e....e@@e..