33,36
354
354
1000
........eee@.e@e...ee@e@e.e@e.e.e@..
w.....ee@@ee.@e@e@e@e.....@e@.@e.e.w
......@e....@e....e@@@eee...@e.e@e..
..e@..e@....e...e.@eee@@@e@.e@......
w..e.ee@ee@..e..@ee....ee@e.e@e....w
....e@....e..@e...@e............ee..
........@e@.e.............e.ee@e@@..
w.ee@ee@e@.e@..........@e.@.@@@e.e.w
..@@e@@@ee@e@e@ee@e.e..e..e.eee.....
..e..eee.e.e@e.e@@ee@..e@........e..
w...e@e@e@...e@..ee.@e..e.......e@.w
..e@@.e@ee@e.@e..e@.e..e@e.e........
..@ee.e@......e@e@...e.@e..@e.......
w...@..e..@e@e..e.@e.@e..ee@e......w
..eee@eee@eee..e@ee@e..@e@.@ee@e.e..
..@@@.e@@ee@@.e@e@ee@.ee@e.e.@e..@..
w.eeee@...@@e..ee@@@e.@e.@.......e.w
..@e@e@e.eee...@eee@e..@ee..e@e.....
..e..e@..@e.....@.e.....@ee.e@.e@e..
w.....e.e@e@....e.@ee..ee@@e.ee@@e.w
...e..@..e@e@e@eeee@@@e@@...@e@@e@..
...@e@e.e@e..@.@@@e.ee..e.e@ee@ee@..
w..e@...e@@..e@eee@e@....eee.e@e.e.w
....e@@eeee..e..ee@@eee.e@@@..e@....
..e..ee@@e..e@.e@.e@e@@e.@ee........
w.@...e@@e........ee@....e...ee....w
..e@..@ee.......@e@@e@e..@e.e@@.....
...e......e....eee.eee@.e.@e@@ee....
w..@e@.@ee@e@ee@e@..@ee@@ee@.e.@ee.w
...e.e.e@@@e@e@.@@e..@ee...e@e.e@@..
..ee@e.e@ee.e...ee...........e@e.e..
w.@@e@..e@.....e@@ee.........e@ee..w
..ee...e@........e@@e..........e@e..