33,36
369
369
1000
..e@e@e.ee..e@e@...e@@e@.e@e.e@@e...
w..ee@@e@@e...ee....ee.e.@@e..ee.e.w
.....eee@ee@e.@@e..e@.e@.eee.e@@e@..
.....@..@e@e.@e.@e.@e.e.@e@@ee@e.e..
w....e@ee..@ee.e@.e@e.@.e.e@e...e@.w
.........@e@e...e@e@e.e.e@@e....e@..
.......e.ee@@e..ee..e...ee..@e@..e..
w....ee@...e@eee@@e.@@e.@e@.e@e.e@.w
.....@.e..@e..@@e.e@eee...e@...@e...
.....ee@e.e...e@ee@@ee@e@@ee...e....
w.eee.@.@e..e.e@e@@e.@e.ee..e@.@...w
..@@@ee.e..e@.@e@ee..@e.e....e@e....
..ee@e..@e...e.ee@@e.e..@...e@......
w..ee.....e..@e@@@e@.e@ee...e......w
..e@@e..e.@e@ee@ee....@e@.ee@.......
...e@@.e@.e....e.e....eeee@@e.e@e...
w...ee.@e.@e..e@.@e@e..@@e....@e@..w
....e.e@e@e@..e@eee....e.e@@e...@e..
....@ee@e@e@..e..@@.e.....eee@e@e...
w..e@ee....e.e@@eee.@e@e..e.e@e@e..w
..e@e.@e....e..e.@e......e@.eee@ee..
..@e@.e@e@ee@.....e......@@e@.e@e@..
w.@e...ee.@e.....e@.e@e..ee...@e...w
..e...e@@ee@e.e...@ee.....e...e@....
..@.e.ee@@ee@e@..eee@e...e@...e@e...
w.ee@.@@e.....e..@e@e.e@......e@e@.w
.....eee..e@@e@.eee.@e@e......e@ee..
...e@@@@e..ee.e@@@@.e....@e...e@e...
w...eeee@e.e..@eeeee@....e..ee@@e..w
..e@e....@e@e@ee..e@e@......@e@e@e..
.......@e@@.@..@.e...e..@e@ee.eee@..
w...@e.e.eeee.ee.@......eee@..@@e..w
....e......@ee@@ee......e@@e..ee@...