33,36
368
368
1000
......e@e...e.......ee...@ee@.ee@e..
w.....@@e...@e@e@.e.@@e..e@.e.@eee.w
......ee..@e....ee@.ee@...e..e@ee@..
.....e.e@.e.e...@@.e@.e..e@..e.e@e..
w...e@e.eeee@@e@eee@e.@...@ee@.e@..w
..e.@@e..@@e.e..@e..@ee...e...e.ee..
..@eee@e@e@e...@ee@e.ee...@e.e@e@@..
w......e.......e@@e@e@@e..e...e@@e.w
...e.e.@ee@e@e..e@e.........e@e@e...
...@e@e...e..@...@e@e..e@e@ee@e..e..
w.eee.@.....ee..@e..............e@.w
..@@@@e....e@e..e@e@e@e@.e.e@e..e@..
..eeeee@e@e@@e.e@e@..eeee@e.e@e@.e..
w.........@@e....e@.ee@.e@@e@e@e...w
...eee..e.ee...e@ee.@e..@ee@........
..e@@@ee@@e..e@e@@e@e@....@e........
w...e.e@.ee..e@.ee@.ee...e@......e.w
.....e....@...ee.@e@@@ee..e.e@e@e@..
....e@.@e.e@.e@@...eee@@e@e.........
w.ee@e.e@..e.@@e@e...e@@ee...@e....w
..@e.@e.ee@..eee@e@...ee.@..ee@.....
.....ee.@ee...e@e.eee@e..eee@e......
w...e@@e@@e@e...@ee@..@e.e@@@e.....w
....@ee.ee.@e....@e@..e@.@@ee.e@e...
..e.......eee@...e@e..e@eee@e..e@...
w.@@ee@e@e@..ee@e..e......e.@e.....w
..ee.@e..e@.....e..@...e@e@e.....e..
...@@eee@ee@e.ee@e.e.e@e@e@@e...e@..
w..eee@e.e.@e.@ee@...@ee@ee....e@..w
.....e.@.@ee...e.ee.e@@e.@@e........
...e.@.e.e@@e.e@e@@e@e...e@...ee....
w..@ee.@e@@e.e@.e@@ee.e.e.e...@@.e.w
..e@e@e@e.e..e@e@ee..e@e@e@...eee@..