33,36
358
358
1000
...e@@e...e@ee@.....e@e@@ee@e.......
w...ee@e@e@.@.e..e..e@eee.e...e....w
...........@e....@e...e..e@...@e@e..
...@e....e.e.e@e......@e@e..@e......
w..e@...e@...ee.e.e...e@@e..e@.....w
..@e.....e@ee@@.@e@.....e@.@e.......
..e..e.e.@ee@ee..ee.....@..e@@e.....
w....@e@...@e.@ee@..@ee@e.e@.e.....w
....eee@e@eee.e.@ee.e.@e......eee...
..ee@e@@e.e@@e@.e@@.....e@e...@@@e..
w.@@.@@ee@e@ee@..@e...e..e....ee...w
..ee.ee.e@ee@ee@.e@e@.@.e@@e........
.......e@..@e@.e....e.ee@ee...e@e...
w...eee......@e@.e@..e@@....e..e@..w
..@e@@@eee@e@e@..@e...eee...@e.@@e..
..e.@e.e@@..@e@e..@ee@e.@e.....ee...
w.@ee@..@e..ee@e@e.@.@e..e.........w
...e...ee@.e.e@ee@.e.e@..@...e......
...@e@e@@ee@....e.....ee@e..e@e@e...
w....eee@e.@e...@eee.e@e@....e@@e..w
....e@@e@e.ee....e@@e@@ee...ee@e....
..e..e@e@ee@@@e..e@e@.e@@e.e@.......
w.@e.e@e@.e@eee...ee....e@.@e.ee...w
...e.e@ee.e..e@.e..@e@eee....e@@e...
..e@..e@@e@.e@.e@eeee@.@@eee....e...
w..@e.@ee@@ee@.@ee@eee.ee@@@.e@e@e.w
..ee..e@.ee..ee@@@e@@e..@.ee.e@e.@..
..@e.e@e.@e....eee......e@e@..@eee..
w.e@.e@@.@e.ee..@e.........@e.e.@e.w
.....@ee.eee@@.e.e@e.e@...ee@...e@..
....e@eee.@e@e@@e.....e..e@@e@e@e...
w.@e.e@@@@ee..ee@.....e..e@@e......w
..e....eee@@e.@ee@e...@e..ee........