33,36
370
370
1000
..e.ee@@ee.e.@e.e@e@e@@e.e@ee@e.e...
w.@e@eeee@.@.e.e@.ee.ee...e@....@e.w
....e@@@e.@e..ee..@e....e..e@e.e@@..
...e..e.@ee..e@@ee@e@e..@.e@@e..ee..
w..@@e@e@ee@ee@@e@.e.e@@e@e@e..e@@.w
...eee@@ee@@e.ee.@e@eeee..@@ee@@@e..
...e..e@..@e.e@@eee@@@e@e.ee..eee...
w.e@@e.e..e..e@@e.eee...@e.@.......w
...ee.....e@e@ee..@........e...ee@..
...@e..e@e..@ee@..e@e@.........@ee..
w....@eee@....@..ee@.e.......e@.@..w
.....ee@e@.e..e.e@.e@e@eee@e..e.e...
..e@e...@e.@ee.ee@e@e@..@@e.e....e..
w.@...e.....e@.@@ee...@ee..e@...e@.w
..e...@.....@e.eee@e@ee....e@e......
....e@eee...e..e@e@e@e..e@.e@e......
w......@@.e@@e@..e@ee@...e.........w
....e@eeee.e@.e..e@@e@@e......e.....
....e@@e.@e.e.eeeee@.ee.e@e@@e@eee..
w....e@....e@e@@@@@e..@e...eeee@@@.w
...e.@e....e@e@eee...e@ee..e@@e.ee..
..e@e@@ee...@e..e.e@e...@e@.@ee@.e..
w.@e.e@e@..ee.e@@e@.e.....e.ee@ee@.w
..e.e@@e@e.@...ee.e.@..........e@e..
..@ee@e....e..e@@e@ee..e@e.@e...e...
w.e.@e@...........e@@.@e@e.ee@ee@e.w
..@ee..e@ee.........e.ee@e...e@@e@..
..e@@....@@e.ee@.e.ee.e@@e.....ee@..
w...e....e..e@@e.@e@@e.@e@e......e.w
......ee@...e@e.e@..@e.ee@@e........
....e.@.ee.......e@.e..e.e@e@e.e@e..
w..e@ee.e@....e...e@...@ee@e@e..e..w
....e@e@e.....@e...e..e@e.e@...e@...