33,36
352
352
1000
....e.e..e@@ee@ee@....e@e@e.....e@..
w..e@e@...ee...e.ee@e.@e...ee....e.w
...@@ee@......e@...e...@..e@@e@.e@..
...ee..ee.e@.......@e..e@ee@e.e@@...
w.e@.e@.@@ee....e@.e@.e@ee@@e..ee..w
..@e.@e.ee...@ee.e......@@eee.......
..e@.........e@@e.e@...@e@@e@.......
w...e......e@.e@...e...e.eee@.@e...w
....@..e@e..e..e@e.@@e@e.ee@e.e.....
..e.e@.@e.e@.e.e@e@ee..e@@@...e@....
w.@e.e....@e.@ee@e@.....eee....e...w
......e@eee@......e...e@.@...ee@e...
...e...e@@@@e.....@e.e.eee@ee@@e@e..
w.e@.e@@.eee.@e.e@@e.@e.@@e@@eee@@.w
..@e.@ee@ee@ee...eee....e...@e..ee..
..@ee.....@ee@@e@..@e..e...ee..e@...
w.e.@e..e.e@..e@ee.e.e.@e.e@@.e@e@.w
..e.....@.@e.@ee@@e@e@..e...e.e..e..
..@e.@e@ee...e.e@@e@@e.e@..e@e@.....
w.@e.e@.@@.....@eeee@e@ee@e@.e@e.e.w
..e@.@e@ee.......@@.@e@ee@e..e@ee@..
.............e...eeee..e@@ee@.e@e@..
w...e..e.....@ee@ee@.....e..e..eee.w
....@e.@ee@..e@..@e@e@.e@e@e..e@@...
..e.e@ee@@e.e@e..e..@e.@e@e.e@e@e...
w.@e..@ee@ee@@e..e..e..e.e@e...e@..w
..e@....@@e.@e...@e@@..@.@e@..e.....
........ee..ee.....eee@ee@.e..@..e..
w.e.e@..@....@e..e@..e@..e.@e@e.e@.w
..@..e..ee@e.e@...e@.@ee....e@e@e@..
..e@e@.e@..e.@e....eee@@ee@e.e.e.e..
w...e......@e@@e.e.e@.e@e....@e..e.w
...e@......e.e..e@.e@e@.....e@e.e@..