33,36
367
367
1000
....e@.@e..eee...e@e.eeeee@e........
w....e.e..e@@@e@e.eee@@@@@e.....e@.w
..e.....e@e.e@e.e@@@..eee@.e@e@eee..
..@e.e@ee@.......eee@e..@e...@ee@e..
w........e.e....e......e@ee.e..e@@.w
......e...e@....@e.e@e.e@.@e@@e.ee..
...e@e@@e@ee@.@eee@e@e..ee@e@ee@e...
w.e@@e@e@@e.e.e.@.e.e@e...ee@@e@ee.w
...@e....e@.@...e....e@..e.@e....@..
..ee@e.e@@@ee...e.e..e@.e@e......e..
w.@e.@e.eee.ee.e@e@e..ee@e@e@e.ee@.w
...ee@.e@..e@@e@e.e@@e@..e@e.@e@e@..
..e@@e.e@e.e@e@e@e@.e....@e@..e.@e..
w..@e..@....e....e.......e.ee@@@e..w
..@e.e@e.ee.....e@.........@eeee....
..e......@@.e.............e@e...e@..
w......e.ee.@......@ee@ee......e.e.w
.....e.@e.@eee.....e@.e@@ee....@@e..
...e.@e..e.e@@ee.eeee.e@ee@.@eeee...
w..@.....@ee..e@e@@@@.e@e.e@e.@e...w
..ee......@@ee@e.eeee@e..e@..e......
..@e......e@e@@ee@.@e@..@e@..@@e....
w..e......@ee@e...eeee..e@ee.ee.@e.w
...@e...e@e@e@@..e@@@e@e.e@@.ee.e@..
...e@..e@..e@ee@..ee@e...@eee@@e....
w...@e....e@e..e..@@e@@e@e@..e@e.e.w
....e..e..@.e.....eee@ee@.......e@..
....e@e@..e.@ee.e.@e.@e.e@@e@ee.....
w...@.e@...e@@@.@e...e@..ee@e@@@e..w
....e@eee...eee.@e..@eeee.e@.@ee....
..e.e@@.@e..e@..ee.@e@@@@..e.e......
w.@..ee@e.e..e.e.@eee@eee@.....e.e.w
..ee@e.e@e@..@e@...e@e...e.....@e@..