33,36
361
361
1000
..@e@...e...@ee@@ee@@eee@e..e@eee@..
w.e.e...@.e@e.@ee..eee@@..@ee@e@.e.w
....ee@ee.....e@.....e@e..e..ee@e@..
..ee@.e@.e@e......@e@e.e@...e.eeee..
w.@e.e@e.@e...ee@.e..e@ee..e@.@e@@.w
...e..e@@ee..e@@e....@e..e@ee@...e..
...@e.e@e@@e.@e@.e@e.e@.e@@e@e...e..
w.e.......@e.@eee.eeee@...eee@.ee@.w
..@.......e..ee@@e@@@ee..@e@e@e@ee..
..e...e@e@e...e@@e.e.....e@...@e@@..
w.e...ee.......ee....e@e.....e@e.e.w
..@e..@e.......e..e..@e.e@e..e.@....
..@e.@e@e..e.ee@.e@e@e...e@.e@.ee@..
w.ee@e.e@..@e@@@ee@e.e@e.@@e@...ee.w
..@.e..e..e@e@ee.@e@ee@..ee@....@...
..e.@ee@.e@e@e@.@eee@@e.....e@e.e...
w.@e@.@e....@e@eee@@..@ee@e.@e.....w
....e.@e....ee@e..@e...e@e..........
..@e@.e....@e@e@..ee.....@...e@e....
w.ee@e@....e@@e....@e....e...e@.e@.w
..e.ee.......e...@e.......@ee.e@.e..
..@ee@...e....e@ee..e@e...ee@.ee....
w.e@@e@e.@...e@@ee@e@@e.e..e@e@....w
..e@ee...ee@e@.e.@.e@ee.@e@.eeee@...
.....@e@ee@.@e..ee....@...e.e@@.e...
w...e@@e.......e@e@e..ee@.e@..ee@..w
...e.e........e@..e@ee@.e.@e.ee.....
..e@......e@e@e@e.@.@e.......@@e....
w.....eee@e@eee@@eee@e.......e@ee..w
...e..@@@ee@...e.@@@@e...e.e@...@e..
..e@..ee@.@e.....eeee@..e@..e..e@e..
w.@@e..@e.e@.....@e.ee...eee@e.....w
..ee......@e.....e@e@@e.e@@e.@ee@e..