33,36
367
367
1000
...e....ee@e@eee@e@e....e@..@ee@....
w.e@...e@@e..e@.e.e@e..@eee@e@.e@e.w
..@....@....e@e@e..e@@ee.....e@.....
..ee.e@e.e.ee.....ee@e.@eee...e.e...
w..@e...e@e@@.e..e@e@e...@@ee..e@e.w
..e@e.e@e.@ee.@..e@e..e..ee@@e.e@@..
......e@e.e@e@e@e....e@.e@.ee...ee..
w.e@e.@@e.@...e@e.e.e@@e.@e@@e.@e..w
..@e@.ee..e@e....e@.@ee..e.e@..e@e..
...e...e...e@...e@e.e@.e@e.ee...e@..
w..@..e@...e@e.e.e@e...e@@e@.e.....w
..ee.......@e..@e@.@e..@ee.ee@e.....
..@ee.e@e..@e@..e@e..e@e@.e@@@eee...
w.e@@.@e@..eee..e@e@e@e.eee@ee@@@..w
..e.e.ee..ee@...@e..@e..@@@@ee@eee..
..@e.ee@@e@e@e...@...@e.eeee..e@e@..
w.@ee@@ee@.@@e.e@e..e@e.e@.e..e@e..w
..e.@e@..@eee..e@ee.e@e..ee@.e@.....
..@e..e..e.....e@e@ee@@ee@e@e..e....
w......e@e.....@.e..@e@.e@@e...@...w
...e...e@e@e@e.ee@....e@ee.e...e@...
..e@...@@e.e@e........e.ee.@e...ee..
w..e@..ee@.@@ee.....e@@e@@e..e@ee@.w
...@ee..@e.eee@......ee@e@e@e@...e..
..ee@@e..e...e@..@e.e.e@e@eee@..e@..
w.@e...e@@e.e@e.ee.e@..@e@e@@e.....w
.......@eee.@@e.@e....ee.@e.e@e.....
...e@..e@@@eee........@..ee...@.....
w...e...@e....e.e@e...e.e@@@e.e.@e.w
.......ee..e.e@.....@e..e@ee..e.e...
.......@e..@e....ee.e.e.@ee.e.@e....
w.....e@e@ee.....@@e.e@..@@.@.e....w
......e@ee@@e....e@ee@...ee@e.@e....