33,36
372
372
1000
...e@e..e@e.e@@e..e@ee@....e@@e@e...
w..@.......e@ee....e@.e.....ee.@e..w
...e.....ee@e@e@e....e.e@e..eeeee@..
.....e@ee@@......ee.e@.e@e..@@@eee..
w..e@@e.eee......@@e......e@ee.e@..w
....e@ee@@e.e@...e@e@............e..
.......@e@e@.e.e....e.e@e.e.....e@..
w.....e..eee..e@e@e..e@e@.@e.e.....w
...e@e@@e.@e...e@....@ee.....@e.....
....e..e.e@....e@e...e@@.e...e@.....
w......@..e.e.e@@e.e@@.e.@e..e@e...w
....e@ee...e@.e@e..@eeee..e@e@@ee...
.........e@@@e.e@@e.@@@@e.@e.@e@@e..
w...e@e@e.eeeeee.e..eeee@.e@eee@@e.w
......e@.e@.e@@@ee@e@...e@@.e@eee...
..e@...e....@ee.e....ee..ee@@e......
w..e@..........e@....@@e..@e@e.....w
..eeee.....e@e@e@...eee@e@....e@e...
..@@.@ee@e...e.@e..e@@e@.e@e.e@e....
w.ee..@e.....@@e....e@ee..e@e@.....w
..e...e@....@ee..e...@ee...e...eee..
..@.e..e.e..e.@ee@@e.e@@ee.@e.e@@@..
w.ee@..@e@e.eee...e....ee@e@....ee.w
..@e...e@e@.@@@e..@e@ee@ee@e.e..@...
..@e.e...e@eeee@..eeee@@e@.e@@..e...
w.ee.@e.e@@e@e.@e..@@@eee@eeee.e@..w
..@@e@e@..e@e@.e..eee@..e@@@e..e@e..
..ee...e......e..e@@ee@e.eee..ee@@..
w.ee..e@ee....@..ee@eee@...@..@eee.w
..@@.e@e@@ee.ee..@e@@@@@e..e@e..e@..
..ee...e@..@e@@e@e.eeeee....e@.e@e..
w.e@....e@e.e@e...ee@.e@ee..e@.....w
..e@e..e@....e@e@e@e@e.e@@e@ee.e@e..