33,36
370
370
1000
....@ee@e...@e.ee.@e....e@.@e....e..
w...e.e..e@.e..@@.e.e@e.eeee....e@.w
..ee..@..@ee@..eee@@eee.@@@e.@e.e@..
..@@e.e..eee@....@ee.@@eee@e@ee@.e..
w.e....@ee@@ee..e@ee.e.@e@e..e@ee..w
..ee...e.@e@e@e@...@.e.e@@ee.@ee@...
..@@e......e.e.ee..ee@.e@e@@.e@@ee..
w.e@e........@.@@ee.e@ee@e.e.e@ee@.w
...ee..e...e@e.ee@@.@.@.......@e....
..e@@@e@.....e..e@e.e.ee......e.....
w.e@eeee....e@...@e@...@@e...e@....w
...@ee@@e...@e..@eee..eee@....ee.e..
...ee@......e@..e.@e@.@..e@e@e@@e@..
w.e@@e.@e...@ee@e..@eee.eeeee@..e..w
...e@@ee....e@.@ee@e@@ee@@e@e@e@@e..
....ee@e@.ee@e.e@...ee...ee@e@@e....
w.....@eee@@e@.ee...@@e@@e...e.....w
......ee@@.e...@@..@ee@eee@e@...@e..
..e...ee@e.....ee.ee.e@e.ee.e@e.e...
w.@e..@e@...e.e@@e@@e...e@....e..e.w
..e....ee@e.@...ee@ee....@e...@ee@..
..@e...@e..ee...e@..@..@ee...e..e@..
w.@e......e@e...@e..e..e.@.ee@e.ee.w
..e.e@e@e.e@@.e@e..e.....ee@@...@...
....e.e@@@eee.....e@..e.e@@eee@.e...
w..e@..eeee@.e....e@ee@@e@e@e.ee@..w
...e@e.ee@e@.@ee@e...e@ee.ee@@e.....
..@e@.e@@..e...e@e@e.e@e@e@@@e......
w.eee.@@e..@e...e....e@.e@@eee@e@..w
..@@e.ee.@e.....e@.@e.e..ee.@...e...
..e...ee.e..@e@e.e.e..e..@e.e.@e@...
w.@e@e@@ee..e..@e@e@..@.e@....e....w
..e......@e...........e..e@e........