33,36
361
361
1000
...............e@ee@@e.....e@e@ee@..
w...e@e.e@e@.e.e@e.eee.ee@e@ee@e.e.w
......e..e@e.@e...e@e@.@@e@e@.e@....
......@ee..@.ee@e.@@ee.e.ee.e@e..e..
w......e@@eee@@e..eee@e@.@@.@e..e@.w
...e@ee@@e....e@.e@e@....ee..e..e@..
........e.....@ee@e@..e...@e@@...e..
w..e@e@e.e...........e@..e@eee@.e@.w
.........@e....e...e..e..e@e@.ee@...
..@e..eee@@e..e@...@..@@e.e..e@e@...
w.ee@e@@ee@e@.@e...e.@ee..e.e@@ee..w
..ee@ee@e...e..@.....e@..e@e.@e.@e..
..@@e.e@.......e...e@e..e@@e.e@.....
w.e.e@@e.e@....@..e@e@..e@e..e@....w
..@e@e....e....ee@e.e@eee@@@e@ee@...
..@ee@ee.e...eee....e@@@.eee@.@ee@..
w.ee@..@.@@e.@@@e....eee.....e@@.e.w
....e@ee@ee..ee.e@e@........e.ee.@..
....e....@...e@.@eee.e@ee@ee@....e..
w...@@e.@e...e...e@.e..@e@@@.@e@e..w
..e.ee..e@.ee@.....e@e@e.eee@e@.....
..@.@e....e@e@e.e.....e@e..@@e.e....
w.ee@@e.e.e@.e@.@.....@eee.eee.@e..w
...ee@.e@@ee.@eee...e@@e@@e..@e@@e..
..e@.ee@@ee.e@.@...eeee@.@e@ee.e@@..
w..e...@ee@e.e@e...@@e@.@e......ee.w
..e@.eee.@e@e@.e@..e@...e...........
...ee@@@eee@e...e...e..e............
w..@e.e@ee.e@e@e..e@e@.@e..........w
..e....e@@@e......@@eee@ee..e..e.e..
..@....@eee..ee...eeee..e@e@@ee@.@..
w.e.eee@e...e@@e..ee@@e@@eee..e..e.w
...e@@e..........e@e@e.e.e@@e.@e....