33,36
357
357
1000
..@e@@ee@e.e@e.e@ee@...e@e.e@ee@e...
w.e.ee@..e@e.@e@..@eee@e....ee@@ee.w
....e@@ee@..e@.....e@@e.......@e.@..
.....ee@.....e.e.....e.....e..e..e..
w....@@.......e@....e@...ee@e@.e@@.w
.....eee..@e..@ee@e.@.e@e@.e.e..ee..
..e..e@@e@e..@e@....e.e@..e@.e@e@...
w.@e.@.@ee@..ee@e...ee.ee..e@e@e@..w
..@e.e.e.e.e@e......@@e.@..@e@eeee..
..e.....e@.e@e......e...e.....@@e@..
w...e.e@e@e.@e..e@e.e...@.e@e.ee.e.w
...e@@e..ee.e...@.e.@ee@e..ee.@@e@..
..@e.e.e.@@e....e.@e.e.@e.e@@ee.....
w.e.e@e@ee@..e...e@e.@ee@@e.e@@@ee.w
...e@e@e@@e.e@...e@ee@e@.e...eeee@..
...@@e@e.@e@e...e@@e.e@@e..e@@e..e..
w..ee.e..e.e@e..@ee....e@..ee.@.e@.w
..e..e@....e.@ee@.@..e.@@e.@e.e@e...
..@..e@@eee@e..@e.e..@eeee.e..@e@...
w.e..@eee@@e.e@e.....e@.e@e@....e..w
.....@ee@.e@........e@@e@e.....e@...
....eee@...e...e...e@@e.e@e...ee....
w...@@@e.ee@...@e...@e@..e@@ee@@...w
...eee.@e@e@.e@@e...e...e@.e.e.e@...
...@..ee.e.e.@ee@e...e....e..@e.e...
w..e..@@e@..eeee@@e.e@..e@@..e@.@e.w
......e..e@e@@@.e.....e..eee@@ee@e..
........e@e.@eeee.....@.e.@ee@..@e..
w.......@@e.ee@@@eee@ee@@...@e..e..w
......@eeeee@.ee@e@@e.@ee....e@e.e..
......e@.e@e@e@ee@@e@e@.@.......e@..
w.......ee@e@e.@e.e..ee.ee@e@e..e..w
.......e@............@e..@e.....@e..