33,36
367
367
1000
.....e@....e@..e@e@e.......e@.......
w.....e.....e..e.e@e.....@e@e....e.w
......@e..e@@ee@.@...@e.@e@..ee@.@..
..ee...@...e..eeee.e.e..e....@ee.e..
w.@@...e@e.@e.@@@e.@ee.e@..e..@e...w
..eee@ee@e@eeeee@ee@@@e@e..@e.e..e..
.......@e@ee@@e@@e@ee.@e@e.e.e@e.@..
w........e@@ee..e..e.....@.@e@@e.e.w
...@e@e..e@e.@ee.e.@@e...e..e@e.e...
...e.e.e..e@e@e@e@@ee...e@..@e.e@...
w...e@e@..e@@e...@e...ee@ee@e......w
..e....@e..ee@.e@e...e@@e.e@e.e@....
..@e.e.e.....e.@ee@...e@e......e....
w...e@..e@e..@e.e@e...e@e..e.e@....w
..e.e@e@....e@ee@.@e.ee.e.e@..e.....
..@ee@.e.....@e..e@@e@@e@.....e.....
w.e@.e@....e@e....e@ee@e..e@e.@ee..w
......eee..@e..@e....e@e..e@ee@e@e..
...@e.e@@ee@e@.ee@e....ee@ee@...e@..
w.ee....e@@..e.@e@@e..e@e@e@ee..@..w
..@e...e@ee..e@..e@.....@e@e.@e@e...
..@e.@e..@ee@ee..@e@e.eeee@@.@e..e..
w.e..ee....e@e..e@.@ee@@@.ee.ee@.@.w
..e@e@@e.ee@@e@e@e.e.e@ee....e.e.e..
........e@..e..e...e@@..e@e.e@...@..
w...e@e@e.e...e@...eee..e@@ee@ee@e.w
..ee..e@e@@....e@e.@e.ee@e...ee.....
..@@e..e.ee....@e..e@e@@e...e@@e....
w.ee@..e..e@e@.e@@e.....e@.e@.e....w
...e@e.@e@e..ee@@ee@.e@e@e.@@e@.e@..
....@ee@e@eee...e..e@e.e@e.ee.@e.e..
w.e.e@e@e@.@@e..e@e...e.....@.e..@.w
..@e..e@ee.e.@e@e@e..e@...e@e....e..