33,36
361
361
1000
..ee@e....e......e@e....e@ee@e@@e...
w.@ee@....@...ee@ee@..e.e@e@@eee...w
..e@.....ee..e@ee@e..e@.e@e.ee@e@...
..ee....e@@e@e@@@@e..e@..e@ee@@ee...
w.@@e.e@e@eee.eeee@.eee.e..@@@e....w
..e@e......@..@..e..@@e@@e@eeee.....
....@.e....e..e@e@@ee..e@@ee@.@e.e..
w..ee@@ee@ee..e@..eee.e.e..@.e@ee@.w
...@ee@ee@@@e.ee@..@@.@e@.eee....e..
..e@e@..@ee@ee@.e@eee..e..@e@e@..@..
w.e@e....e@@e...@e..@ee@...e@@e@ee.w
..@.@e@.e@.e..ee.e....e@e.e@e..@e...
..e...e@e...e.@@e@e.e@eee.@e@..e....
w..e@..@e..e@@ee@@e...e@@e.......e.w
....e@ee.e@eee.@@e....e.......e.e@..
......@ee@e.@..ee.....@e.e@e.e@.e@..
w...e@ee@e@.e.@e.e@..............e.w
..ee@.....e@..e...e.e.....e@..ee@e..
..@@e......e.....e@e@e@e@..e..@e@@..
w.e..e.....e@ee@eeee@@@ee...eee.ee.w
....e@...e...@.e@@@eeee...e@@@.e@e..
..e.e@e..@...ee..ee@..@e...eee.@....
w.@e@e@..e...e@.....e@e..ee@ee.e...w
..e.....e@......@e.....e@@ee@@e.....
..@ee@.e@.....e.ee...e.@e.e@@e@.....
w.e.@e.e..e..e@e@@..e@.....@e......w
..@e@e.@.e@..e@@.ee@@e.....e..eee@..
..e.e@.e@e...@ee.e.e@ee@e....e@@ee..
w.@e@..@..@e@....@e@.ee@...@eee@...w
.......ee.e.e.....e..@ee.e@ee@@e@...
....@e.e@.@e....e@@ee@.e@e@...e.e...
w...e@..e..@e.@e@e@e@e..e.e..e@ee..w
........@ee@e.e@........e@e..@ee@e..