33,36
361
361
1000
.....e@..e..@e@e.e...e@e@@e...@eee..
w.....e..@e.e.@e.@ee..e.ee@...e.@@.w
....e@.@e.e@e.e@e@.@....e@.e.ee.ee..
....@e@e...@e.@e.e@ee..ee..@e@@e....
w.eee....e.e@e@@....@@e@@e..e@e@...w
..@@@e.e.@@e..ee....eee@@e...e......
..eee@.@.ee........ee.eee@..e@......
w..e@..ee@@e.e.....@@e@............w
...@e@e..@e.e@.....eee@e.......e@...
..ee.....e@..@e@.@ee@@e......e..ee..
w.@e.@e......e.e@e@...@......@e@e@.w
.....e.....e@e..ee@...e@.e..@e@e....
........e..@@e@e@.e.e@eee@eee.ee....
w.....e@@e.ee.e.e@..e@e.e.@@ee@@ee.w
..e@...e@e@e....ee...e..@@e@.e@ee@..
..@e@ee@.e@ee@e.@.e@.@e@eeee.e@..e..
w..ee@@e..@ee@@ee.@ee@e..e@@e.e@e@.w
..e@@e@e@.e@@e@e.e@@@e.....e@.eee@..
....e...e....e@e..eee.....e@.e@@.e..
w........e..e@e@e..e@@ee....@e@ee@.w
.......@e@e@....@.e@.e.@e@..ee@ee@..
.......e..@ee@e@e..e..e@@e.e....ee..
w..ee..ee@e..ee@@e.@...e.e@@e..e@..w
..e@@ee@@e@.@e@e.e.e...e.ee@@@ee@e..
...e@eee....eee..@.....@e@eeee@e@e..
w.ee@e@@e.e@e@@e.eeee..e@.@@ee@@@e.w
..@e.e@@e@.......e@@@e.@e.e...eee...
..e@..eeeee...@e.@@ee..e....e@e..e..
w.e@e...@e@..@ee.ee@@e@@e...@e...@.w
.....e@......ee@......e........e@e..
..e...e...e.e..e....ee@@ee.e@e@.....
w.@e@@e@e.@.@ee@...e@..e.@e.e.e....w
..e.ee.e@.e.e@@ee@e.e@e....e@.......