33,36
365
365
1000
....eee@e..ee@e.....e..e...@e..ee@..
w...@@@e@..@e@e....e@..@.e.e..e@.e.w
..e@ee.e@......e@e..e@@ee@e@e@ee@...
...e.@e@e..e.....e.e.ee.e@e.e@e@e...
w..@e@....e@e.e..@e@e....@ee@@e@ee.w
....ee@ee...@e@.....@e...e@e@ee@e@..
....@@e.@e.@e...e@.e@e...@....eee@..
w...e@@e...e...e.e@ee@...ee..e@..e.w
.....e....e@...@e...@ee...@e.@.e....
..e@e.....e.e@e@e.ee@e@.....ee.@....
w.e@e.e...@e@....e@@e.......@e@e.e.w
..e@@e@....e@e........@e..ee@e..e@..
..eee@...e@e...e@e.@e.e@.e@..e.@ee..
w.@@e..e.e@@e@e..@ee.e@..e@ee@.ee@.w
..ee@..@e@ee.@e...e..@ee.@@e@@ee....
.....ee@.....e@...@@e.e@.eeeeee@e...
w....@.e@eee@e....ee....e@@@@ee@@..w
.....e..e@@@e.ee@ee@eee...ee..@ee@..
..e@....e@ee@e@@e.@e@@@@e@eee.@eee..
w.@e..e@e..e@@e@eee..eee...@@@ee@..w
..@e..e...e.ee...@@e.....e.eee@@@e..
..eee.@e.e@e.....e.e...e.@e....ee...
w.@@@e@e.ee@....e..@e..@e.@@e......w
..eee@@ee@@....e@@e..e@e..ee.....e..
..@@..e...e@@e@eee.e.......@..e..@..
w.ee......@ee..@@ee@...e@@ee.e@..e.w
..@.eeeee...ee@e..e@.e@@eee@........
..ee@@@@@@ee@...e@@e..e@@..@e.......
w.@e.eeeeee..e...e..e..eee.e.......w
..e......@@.e@e.....@.e@.@e@@e..e@..
..@e...e.ee...@e.e@ee@e@.ee@ee.@ee..
w.....e@e......e.e@e@..ee@e@@@@ee@.w
........@e.....@ee@ee@ee@.@eeee.....