33,36
366
366
1000
..@e@@e....e@e@e@e@..e.........@e...
w.e.ee.e...e@e....e..@e..e.....e...w
..e...e@.......@e@e......@e...e@e@..
..@ee@e@.e.e@e.e...ee...e@e@..@e@e..
w.e@@e.e.@.e@@ee.ee@@.e...ee.......w
....@ee..e..e.e@e@@ee.@...@@e@......
....ee@e@...@e..e@e.e@e.e.ee@e..e...
w.e@.@e@e.e@e@.e.e@.@..e@.e@ee@e@e.w
..ee@e.@e..ee@e@.@e@e..@e@@e.@.@e@..
..@@e@.e.e..@.e.e..@e..e.e..ee......
w.ee.e@e.@..ee@e@e.e.......e@...e@.w
...@ee@e@e...@e@..@ee......e@@ee.e..
..e@e@e@.e@ee@e...ee@e..eee.eee@....
w.@e.ee.e@@e.@e..e@@@e..@@@e@..e@..w
..@ee@@...e..e.e..@eee.eee.ee@..ee..
..e.eee.....e.e@..e.e@.@...@.e...@..
w..e@@e.....@@e@ee@.e@.e..@ee.@e@e.w
..e@e@e.....ee......@e....e@@ee@....
..e@e.....e.@...e..e@......e@e......
w.e@e@e..e@.e..e@..ee...e@e@@e.e.e.w
..e@ee....e@@e@.e..@e...e@e.ee.@e@..
....e@e@e..ee.ee@@e....e@@eee@e@ee..
w.e..e@e.e@@@eee@e.e@....ee@..@e@@.w
..@e..e@..ee.@@@e..@e.....e@e.e.@e..
..ee..@e..ee.ee.e@.e@..@e.@e@.e.e...
w.@@..e@ee@@.e@e.e.....ee.@e..@e...w
..ee...e@@@e@@e...e...e@@eee.e@@e...
..e....@.ee.ee@e.e@......e@@e.e.....
w.@....e..e...e@.e@e...e@e@@e@@e...w
..e.e@...e@@e.ee.......@eeee.e..e...
.....e..e..e.e@@.e@....e@@@e.e.e@e..
w.e....e@..e.@@ee@e..e@..e@.e@e@e..w
..@e...@e.e@.eee@e...@e...e@e@ee@...