33,36
350
350
1000
..@e...@e@e@ee.e@e....@e...e@e@.....
w.ee@..e.ee@e@e.e@....e...e@@ee....w
..e@e.e@ee.e@.@e@e@e@e..eee@e@@e....
..@e@.e@@@e@@e..........@@@e..e@.e..
w..e@eeee@e.e....@e..e..ee@e.ee.e@.w
.....e@e@@ee@@e@eee@e@@e@e@@e@@ee@..
.......@ee.@.ee..e@...e@.@eee@e@ee..
w....e@e@@.e..@........e.e@@...e@..w
.......e.ee@..ee@e.....@e@.e.e@e....
......e@..e@eee@e@....@e...@..e@.e..
w..e.e@....e@@e@e@ee..e..e@e..@e.@.w
..e@.@@e......ee..e@.e@..e@......e..
..e@eeee......@@.ee@e..e..e...e.....
w.e@@e.@...e@eee.@....e@.e@...@....w
...ee@.e.@e@e..e.e.@e....e....e.....
..e@e@@e@ee.@..@...e....e@@e.....e..
w.@eeeee@e@ee..e.ee..e@e@ee@....e@.w
..e.@...e@e.@..@e@@e@e@@e@e@e....e..
..@.e.....@ee..e@@ee..e.e........@..
w.e.....e......e.e@@e..e@..@e@e@ee.w
..e@e@e@@e....e@.e..e@ee@eee@..e@...
..e..e.ee@.@e.@..@....e.e@@e........
w.@e..e@e@ee@.e..e.e.e@.@@e.e..@e..w
..@e...e@ee@@e@....@e...ee@.@e.e....
..e..ee@.ee.e@.e@e....e....e..e@....
w....@e.e@@e....e@.@e.@....@..e@e..w
....e...@e@e......@e..e.e..e...e@e..
...e@...ee...@e..eee...e@..@e@.ee@..
w.e@e...e@.eee..e@.@.e@@@ee.@e@@@..w
..ee@.e.@@e@@e@.e@ee..eee@@e..eee...
..@@ee@.ee....e....e@e.@.e@e@.......
w.e@e.e@e.........@ee.ee.e@ee@e....w
.........e@e..e@e.ee@e@..@e..e@e@e..