33,36
353
353
1000
...e...e@e@e..ee@.......e@e.........
w.e@...eee@@e.@.ee@...e@...........w
..@ee@.@e@ee@.ee..e@e.@e@.e@e@......
..e@.e....ee...@e.eeee..e..e@ee.....
w.ee..e..e@@e....e@@@@ee@.e@..@e...w
..@@e.@e@e@e.e...eeeee@@@e...e@e....
..e...@ee@e.e@...@@e...ee......@e...
w.e@..ee.e@@e....eee.e@ee@......e..w
..@e..@@e..e.e..e@@@@e@e@e......@...
...e@ee.e.e@.@e@..eee@.e@@e.e...e...
w..e@.@e@......e..e.....e@@e@.e....w
....e.e@....e..e@.@e@e...ee@e@@e....
...e..e@eee.@..@ee@e....@e...e..e...
w..@e@e@e@@.e@e@e@e@ee@@e...e@.e@e.w
..e@.@ee..ee@@ee@..e@.eee@..e@e.e@..
...e.e.@.....e...e.......e.e@.@e@...
w...e@.e.....@e..@e@......e@e...@e.w
....e...e@e@e@eee@ee.......e@e..e...
..e@@....e@@e..@@e@@e....@ee@@e.@...
w.@ee....@eee..e..e@e..e@e.@e...e..w
..e@.e@@e.e@@e@ee@@@e.e@.@ee....e@..
...e@eee.ee@e@..@eee@.@....@e...ee..
w........@e@e..e@ee.eee.ee@e..@e@..w
...@e...e@ee@...e@@e@@e.@eee..ee@e..
...e@...e@e@.@ee@ee.ee@@ee@@ee@e@@..
w..e@e.e@e@..e..e@@.@.@e...ee.e.ee.w
....e@.......e@e@ee.e.e@..e@@.@.....
..ee@e@.ee.......@e...e@e.e@e.e@e...
w.@e@ee.@@e.e......e@e@..@e..@e.e..w
...e@e..e...@ee......e@e.e...e@e@...
...eee@e.....e@e@e@.........e@.e@e..
w.e@@e@@e.e..@e@..e.......e@....@e.w
..ee@eee@e@.e@e.e@e.......@e....e...