33,36
358
358
1000
..e@....ee@e@.e@e@.e....ee@@e..e....
w..ee@..@@eee.@e.e.@e..e@@eee.e@.e.w
..@e.ee@e.e@@e......@e..e@ee@e@.e@..
..e.e@@e@..e@eee@e@e.@e@...e@.......
w............e@.e@.....e....e......w
..@ee@ee@.....@e@e.e@.e...e.e@e.....
..e..e@.e.eeeeee@@..e@@e@e@@e.e.....
w..e@e...e@@@@e.eee@ee@e.@ee..@@e..w
...e@....@eee@.......e@..e@@e.ee....
...@ee@....@ee.......ee@e...@e@@e...
w.@e@@e@ee@e.e...@e..@.....e@.e@e..w
..ee@@ee@@ee@@.eee...ee...e.e...e...
..@eeee.e.@eee.@@ee...@e.e@.ee@e@e..
w.e@.e@.@ee.@..e.e@...@e@ee.@ee@...w
.....e@e@e@.e....@e...e.e@@.@e......
..@e.ee.e.@e..e..ee.......eee..@e@..
w.e.e@.@e.ee@e@..@@.......e@@e.e.e.w
...@e@eee@e@@e@.@ee...ee.e.@e.......
...e@...@e@@e.e.e....e@@.@ee........
w...ee@@e.@e.e@....e@e@e@.....e@ee.w
..e@@eee@.e..@e....e@e@.e.......e@..
..@e.........@e..e.@e@e@.......e@e..
w..@eee..e@e.e@e.@e....e..e@e..@@e.w
...e@@@e......e@.e...e@....e@..ee...
...e@e@e@...e..ee@.eeee.e@e@........
w.@e@ee.e..e@.e@e..@@@@e.....e@.e@.w
..ee@e@@e....e@@e.eeeee...e@e.e.ee..
..@e@@ee...e@e@e..@.e@@e..e@e...@e..
w...e.e@...e@@e..@e.@e@e..e@ee@e@..w
.......e@e.ee..e.e@.ee...e@.....ee..
...e...e@@e@..e@@e@e@@e@e@e@....e@..
w..@e...e.@e.ee@e@....e.e@ee....ee.w
..........e@e@e@e.....@e.e@....e@e..