33,36
360
360
1000
...e@e......@e....e.e@@e@e.e.e@@e...
w...e@e.....e.e..e@@eee.e@.@e.ee...w
....e@@......e@e.e@e@....e@@e@.@e...
.....eeee@e.e.e@@e...eee..ee.e.e@...
w..e@.e@@..e@e@@ee@ee@@@e..@e@...e.w
....e...e@e@.e@e.e@e.eee.ee@@@e.e@..
..ee@.....@....@.....@e@.@eeee@@ee..
w.@.e...e@e....e....e@e.ee@....ee@.w
..e....e@@ee.e....e..e@e@e.e.e.@e...
...e..@eee.@e@..e@@e.@e@...@e@.e....
w..@.@e..@e@@.e@ee..e@eee......@e..w
...e@e.e...ee.e@......e@@@ee@.......
...@e..@ee....@e.e@.....ee..e.......
w...@.e@e@.....@e.e..e......e..e@..w
....eee@e@ee@e.@e.e@.@e..@e.@e..e...
...e@@.ee@e....e...e.e@e@e.ee@..e@..
w....ee.e@@e@e.@e....@e@.e@@@ee.@e.w
..@e.@@e@e.....@e.e.e.....eee@@e....
..e..e@@e..e@e.e@e@e@.....e..@e.....
w.e...ee@e@e@@@ee@@ee@e...@@ee.....w
..@.e@@e@@e.eee.@ee.@e.@e.eee@@e....
..e@.ee@e...eee...@.e@.e...@e@e.e@..
w..e...e@..e@@@ee@e.e.......e@e..e.w
......e@...e@e@@e@ee@e@e.e...@ee....
......e@@ee@@ee@ee.......@.e@e.@....
w......ee.e@e.@e@@.e..ee@e.ee.eeee.w
.....@ee@e.e...e.e.@..@@e..@@e@@@@..
.....ee@...@e.e@...ee@e@e@eee.@eee..
w...e........e@@ee...ee@......e.e@.w
...e@......e.e@ee@ee.@ee..e@e@@e....
...@@ee@ee@@.e@@e.@@e......e@e@e....
w.eee.@e..ee..e...e@e.e.e@e....ee..w
..@e@e@e...@e.....e@ee@..e@...e@@e..