33,36
356
356
1000
...e@@e@e..e.....e@e...e@e.e@..e....
w...ee.e@.e@.e@..ee...e@....e..@e@.w
...e@@e.......e.e@@e..@e@ee......e..
....e@......e@e.e@e...e...@e@e@e....
w.@e@ee.e..ee@e...@e......e@.e@@.e.w
..e.e.@e@..@@e@.........e@...eeee@..
..@e@.e.@e@ee.....e..e.@ee.e@@@.e@..
w.ee@e..e...@e...e@.e@.e....eee..e.w
..e@e@...e.e@@e...ee@@e....e........
..@e.....@..ee..ee@@eee@@e.@@e......
w.e.....ee..@@..@.e@ee.eee@ee..e...w
..e@e@ee@@e.ee..e..@e@e@@e.....@e...
..@ee@ee@@e@e......e..@e@@@e..e.....
w..@.e@@eee@e.@e@e......eeee.e@....w
..ee..@e.@@e@.ee.@.@e...@e@@e@.e@e..
..@e..e..e...e@@.e.ee...e.e@e..ee@..
w.@e..@..e@e.e@e.e@.@e....@e..e@@e.w
..e...e..@...e.e@.ee@....@e@.@ee....
.....e...e.e@@.ee...e.e..e...e@@.e..
w....@ee..@eee.@@e....@e.@ee@e.ee@.w
.....e@@e.ee@e@e@e....e@.@e.e@.e.e..
.......@ee@@e@@e@@e..e@..eee...@e@..
w.e@e..e@e@e.ee.ee@..ee@e@@@ee..e..w
..e@....e.@e.@ee..e@e@e@e.ee@@e.@e..
..@e@e..@.e....@@e.e.@e@e.......e@..
w...e@..e.e...@ee..@.e.e@e.e@....e.w
.......e@.@ee.eee..e...@e@..e...e@..
......e..eee@e@@@......@ee@.@..e@e..
w...e@@.e@@@.e@ee.e@...e@.e.e.e@@e.w
.....eee@@ee...@e..eee@..ee@ee..ee..
..e.e@e@@e....e@@e.e@.e.e@e@.@@ee@..
w.@.e@e.e@....@e....e@@e.e@e.ee@...w
..ee@..e@e.....e@e...ee@e@.e@e@.....