33,36
355
355
1000
...e@...e...@e......e.@e@.....e@e...
w...e.e@@e..ee@e.e.e@.e.e.e@@ee....w
..ee@.@e@e.......@e@...e.e.ee@@e....
..@e.e@e@ee@........eee@e@eee@@e....
w..@..@e.@@e.@e@e..e@@....@@eee....w
...e..e..ee..ee.@e...e....e@........
..ee.@e.e.@ee@@ee@@e.@e....ee@.e....
w.@@ee@.@e@e.e@e..e........e.e@@e@.w
..e@@...e@...@e..@e.e@e...e@..eeee..
...ee...e@e.e@e..e@e..@...e@e...@...
w......@e....@e@e@@ee.e@e.e@e..ee@.w
....e..e..e..eeee@e.@e@.e.@@e.e@ee..
...e@....e@e@.@@e@e.eee@@eee....@...
w.e@...e@e@.e@eee@@ee@.ee@@e.e..e..w
.....e.e@@ee@@e..e....e@@e...@.e@e..
...e@@e.e@e@ee.....e...e@...ee.e@e..
w.@eeee@ee.e@@e@.e@@e...ee.e@@e.e@.w
..e@e@@ee..e@e.e.ee@@e@e@@ee.@e.....
..e@@ee@@e...@e.e@@e.@@e.ee@@e.ee@..
w..e...e@.......e@.e.ee@.@..e@e@ee.w
...@...@e.e@e...@e.@..@e.e......@e..
...e..e@e.e@@e..@e.e@..e@e..e@e.....
w..........ee@.eee.@e..@e..e@....e.w
..@e......e@@e@@e@.ee@..e...e@e..@..
..e@......@ee.e.e@e@.e.e@.e@.....e..
w.e...e@e@@e..@.ee@@e@.e@e.e@e.@e@.w
..@....e.ee..eee@.@e..ee@@e....e.e..
..e...@e..@e.@....e..e@@e@e..e...@..
w.e@..e@@e.@ee.e@@e...@ee@@..@e..e.w
...e....e......@ee..e.e..ee..@e@.@..
...@eee..e@e.....@ee@........e@e.e..
w..e@@@.e@e@...e@..e@e@e@......e@..w
...@eee.........e..e@ee.e....e@ee...