33,36
364
364
1000
.....e@..e......@e..e@e..e..ee..e@..
w.ee@@e..@....e@e...@e@.e@ee@@e..e.w
..@ee@e@eee@ee@.e@e...e@.e@ee@e@.@..
.........@ee@@e.e@.@e..e..e@e..e.e..
w.e.ee....e@.....e.ee....e@@e@...e.w
..@.@@e......e@e....@eee.eee@e..e@..
..e.e.e...e@.@e..e..e@@@e@@@e.e@.e..
w.....@.eeee.@e..@e.e@eee@ee@..e.@.w
....e.ee@@@eee.............e@@e@.e..
..e@@e@e@e..@@.e.e...e@.....ee.@e...
w..eee@@e@..ee.@e@.e..e....ee..e@..w
.....ee.e@..@e@e..e@e.....e@@eee@e..
....e@e@ee.e.e@e.e@@e......@ee@@....
w.e@@.....e@e.@e...e....e@ee...e...w
...eee@e@e..@ee.........@e......e...
....@e......e@......e........e@e@...
w.e@e....e.e@......e@.@e.e@..@e....w
..e@e@e@.@@e..........e..eee@@e..e..
..e@@@ee.eeee@e.e.e@ee@.e@..ee.@e@..
w..eee@@ee@@@@e@@e.@e...@e...e.e...w
..ee..ee@@eeee@e...eee@e...e@@e@....
..@@ee@@e@e..@e...e@@...e..@e....e..
w.e@e@@ee@e......e@@e..e@e.e@...e@.w
...ee.e.......e@ee@ee@e@e@e@.e@e....
..ee@e@.e@....e.@e..ee.ee@@e.e.@e...
w.@e.@e..ee..e@@e..e@@e@.ee..@e@ee.w
..e....e.@@e...e.....e@..e@ee.e@@@..
..@e@ee@ee@...@e........@e@@@.@eee..
w.e@.ee@@@ee..e..e@e..e@e.eeee@@e..w
.....@eee.e@..e...@ee@e.@....@e.....
...e@e..e@e@e@@e@ee.eee.e@@e........
w.......e@@e@e.e@@e@@@@e.ee..e@ee..w
.........e@e....e@eeee@e.@e..e@e@...