33,36
346
346
1000
..ee..ee.e@e....e.e@ee.e@@e...e@e...
w.@@ee@@e@...@e.@e@e.@e.ee.@e...e@.w
..e@@ee@e@ee.e.....@e@ee...e..e..e..
...e..@e.e.@...e...e@e@@e...e.@e@...
w.e@...@.@.eee.@......e@e.e.@e.@ee.w
..@.e@.eeee.@@@e.e@ee@@e..@.@e@e@@..
..e..e@@@e@.eee@.....e@@e@e.e@e..e..
w.@..@ee@e.e.ee...e.e.e@e@.....@e@.w
..e........@e@@e..@e@@ee.e.e@..e....
...@e.e....e@.ee.@e..e.....@ee@e....
w..ee.@e..@e.e@@.e...........@@ee@.w
..e.@e@e@ee@...e........e.ee@ee..e..
..@ee@e@..@e@........e@e@.@e.@@e....
w.ee@..@e@e.e...e.....e.e...ee@@e..w
..@e@..ee@e....e@.ee.e@.@@ee@@e.....
....e...@......e@e@@ee@@ee@@@e@e....
w...e@e.e....e.@e.....ee.@.ee..@e..w
...e@.@e@e..e@.e@.....@..e..e..ee...
..@e.e@e.@e....@....e@e....e@.e@@e..
w.e...e@.e@e...e@.............@@ee.w
..@e@.e@ee@@....e.e.@ee@ee@...ee@@..
...ee@e.@eee.@e...@@e.e@e@e.ee.@ee..
w.e@e..@e...ee@...ee....@@e@@@.....w
..@@ee.e@...@e...e@@.e..ee.eee@.....
..ee.@ee@.......eeeee@..@e..e.e..e..
w....e@.e.....e@@@@@...ee...@e@..@.w
....e@..@.e@e.@eeeeee.e@@..e.....e..
....e@@ee.@e........@..eee@@.ee@e@..
w....ee....e.e@e....e@e@..eee@@e...w
.....e.e@.e@.e@ee@e@.ee@..@e@e.e@...
.....@e@ee...@@e.e@e...e..@e@@@ee...
w.e@e..e@@e..ee..@...e@...e@eee....w
..e@e.....e@ee@..e....e...e@ee@.....