33,36
350
350
1000
....e.e............e.e..e@e.....@e..
w.@e@e@e.e@e.e@..e@@.@e...@e....e..w
..e..@e...@e..e..@eeee@....@e@e.....
..e.....e.e..e..e@e.@@e.....@e@.....
w.@e..e@@e@.e@.e...eee@............w
..e.ee.e@e..e@e@..e@@@e....e@e...e..
..@e@@e@@e...e@e@.e.e@..e@......e@..
w.e@@ee@e.e@...eee@.@ee..ee..e@e@..w
..e@e.e@e..e..e@@@e..@@e.@@......e..
..e@@e@@ee.e@e..e.@e.e@e.ee.....e@..
w..e@e@ee@.....e..@e.....e@e....ee.w
..eee...e@e...e@..e....e@e@@@eee@@..
..@@e.....@e...@e.@e...ee@eee@@e.e..
w.e@e..e@.e....e..ee..e@@..@@e...e.w
..e@.@e.ee@...e@.e@@@e@.e.@e....e@..
..ee.e.e.e@.....e@.ee.....e...e.e@..
w.@e..e@..e.e@.e@.e....e..@ee.@@ee.w
..e.....e....e...e@..e@@.e.e@eee.e..
..@e....@.e@ee@e@e@...ee.@e@e@..e@..
w.@ee@..e@..@....@e@e.e@e@@.e@@ee@.w
..e.@e.e.e..e...e@....e..eee.eee.e..
..@.e@e@....e@...e....@..e@@.ee@.e..
w.e.@ee@..e@.e@......ee....e.@e..@.w
......@ee@@e..e...e..@@....@..@e.e..
....e@e@@eeee@e...@@eee...@e..e@....
w..e@@e..e.@e@@e@eee@..eeee.e....e.w
...e@e@.e@e@.e.e@e@.@ee@@@@e@e@e@@..
..e@@e...e@e.eee@...e@@eeee@.e@@ee..
w.e@ee..e@..e@@ee......e@.....e.e..w
..@e.@e......@e@.e@..e..........@e..
..e.@e@....e@e...ee.e@...e@e@e......
w.@.e......@eee..@e@e@e..@ee@eee@e.w
..e.@e@e..e@e@@e..e@e...e@ee@e@.e@..