33,36
358
358
1000
...e..@eee.e......e@e..e@e...ee@ee..
w..@e.e.@@e@.......e@e@......@@ee@.w
...e@e@.eee@e.........e..@e@ee@e@...
...@e.....e@e.e....e@e.@ee.e@.e.....
w.e@e...e.....@ee...e@@ee@..e@@e...w
..ee@...@e..e@e.@...e@e.e@@e.ee@....
..@e@e.ee....e@.e...e@e.@ee..e......
w.ee@.e@@e.........e@@ee@...e@...e.w
..@@eee@@e@e......e@.e@.e.e.e@.e@@..
..e@e@.ee@@e...e@@e@ee...e@..e..ee..
w.ee......e@....ee@e@@..e@.e@......w
..@e..e@ee.....e.@e.ee......eee@e...
....@ee@@@...e@@..ee@.......@@ee@e..
w.e@ee.eee....ee..@...e.....e@..e@.w
..ee@@e.e@e..e..e@e.ee@@ee@e.e......
..@e@@e@@e@..@@ee@e.@e@ee@e@...@e...
w.e.ee.ee....ee@@e@e...@@e.....e@e.w
......e@@e@e....@e@@ee@e@..e@eeee@..
..e@e...@e...e..e.e@e@@ee..e@e@@ee..
w.@@e...e..e@@e@@..@eeeee@e.e..@e@.w
..eee...@ee.e@eee..e@@@@e@e@@..e....
....@eee@e@....e...@.eee@@eee.......
w...@e@........@e@ee.....ee@....e@.w
....e..e@...@e..@eeee@.......e...e..
........ee@.e@e@e@@@ee.e@e.e@@e@e...
w.......@.eee.@e..e@e..e@@@eee@....w
........e.e@@e@e..@e@e@@eee.........
.............e@e..e..@e..@e.....e@..
w...e.......e@e.........e@@@ee..@e.w
...e@@e..@e@e.@..e....e@eeee@@ee....
...@.ee@ee.eeee..@e.e..@e..e@@e@e@..
w.ee..e@@@e@@@.ee..e@@ee.e@@ee...e.w
..@ee@eeeee@eee@@e.e@e....e....e@e..