33,36
368
368
1000
..e@ee@ee...e@.@e..e.e@e...e@e......
w...e@@e@...@eeee.e@e@....e@...e@e.w
....@.ee...e..@@@.e@eee.....e@ee@e..
..e.eee@@e.@e.eee..e@@@@e...ee@@@e..
w.@e@@..ee......ee@e.eee...e@..eee.w
..e@@e.e@@..e@.e@@ee@e.e...e@e@.e@..
...ee...@e...e..@e...@e@..@e@ee.....
w.e@e..eee@e....e...e@e.@ee.@ee....w
..@e@.e@e..e.e@e@...@e@.e@..e.@e....
..e...@e@.e@...e@e@e@e@..e.....@e@..
w.@e.e@e@.e@e..e@e@.@ee@eee.e.e..e.w
..@e.e@ee.e@......e@e@.e@@@e@.@e....
..e..e@e...e..e@....e....ee@e....e..
w.e..e@......e@e..e@@e...e@@e..e.@.w
..@ee.e....ee@@ee.@eee@@e@.e..e@.e..
..e@@e....e@@@e.@...@eee...@e@e..e..
w...e@.....@ee..e..e@e.@e@.....@e@.w
...e@e..e@.e@@e.e......e@eee..eee@..
...e@@e..ee.e@e.@.ee@.@e.e@@ee@@.e..
w.e.e@e...@e....ee@@e.ee@ee@@..ee..w
..@..@ee@ee@.....@e........eee@@@...
..e..e....@ee@e...e@e........@eee...
w..e@@e..e@.@e@.@e@e@..e.e.e@..ee@.w
..e.e@@.eee.e...e@....e@e@..e..@ee..
..@..ee.@@ee.e.e@e....@@e....eee....
w.e...@.e@e@e@e@@e....ee....e@@@e..w
...e@.e@..e.e@@ee...e..ee@e...e.....
...ee..e.e@@ee......@e.@e@e...e@ee..
w.e@@ee...ee.ee........e@e@..@e@e@.w
..@e@e@...@ee@@......e...e@..e@@e@..
..@eee@@e.@e..e@@e...@e..eee...e.e..
w.e.@.eee.e....ee..@e.e.e@e@@ee@e..w
....e.@e@..........e.e@..e@.e..e@e..