33,36
362
362
1000
.......e.e@ee@e.e..e@e...e..e...e...
w..@e@e@@e@e@e@.@e.@@e.e@@ee@.e@@e.w
...e@@e@e..e@e.e.e@ee@..ee.e@e.e@e..
....@ee@e..e@e.@ee.....e@@.e@e......
w...e.e....@e...e@.......ee@.@e....w
......@...e..e@@e@e.......e@..e@....
....e@e.e@@e..ee.e@..e@ee@ee...e....
w...@e@eeee@......e@e..............w
....@ee@@..e@e.e@.@e.e@..@ee.e......
...@e.@@e..@e.@ee@e@..e..e@@e@...e..
w..e@eeeeee@eee@.e..e....e@e.e@e.@.w
....e@e@@@...@e..ee@@e@ee.e@.e@e.e..
..e..e@eee..e....@.e.@e@@e@..e...@..
w.@e..e@e@e@@ee@ee...ee..@...@...e.w
..e@...e@..e..e.@e@..e@..e..eee.e...
..e@e..@e..e@e@...e@e....e..@.@.@e..
w...e.@e.......e@@eee....@@ee.ee@e.w
...e@@e.@e.e...eee.@@ee@.ee.....e@..
...e@e.eee@@e..@@e.e@@ee..e...e.e@..
w...@e@@.@ee.e@eee..e..e.e@e.e@eee.w
....e.ee...@@ee@@@ee..e@@ee@ee.@@e..
...e@e..ee.ee.@eee@@e.e.e@@..@.e.@..
w..@..ee@@.e..e@e@e@..@...e..e.@ee.w
...e..@..e.@..e@e@ee..e....ee@@e@e..
..e.e@e....e.....e@@..ee..e@..e.e@..
w.@e@...e@e....e.@ee@e@@ee@e.e@e@..w
....e@e.e...e@e@.....@ee@e@@e.e@....
..e@@.@e@.e.e@e......e@.e.e@.e@.....
w..ee.e...@.@e.......e@e@.@e@e@e@e.w
..e@e@e@e.e.e@..e@e..e@...e.@e.e....
..@e.@e...e.....e@@e.ee..e@.ee@@....
w..e.eee.e@..e@..e..e@e@e..e@.eee@.w
..e@.e@@e.....e.......@e.......@ee..