33,36
344
344
1000
...e@e@ee...e@e@e..e@e.e@......e@...
w...e..@@e..@e.....@e...e@e@e..@e..w
...ee@ee.....@e..@e@e@...@e....e....
..e@@ee@ee@e.e@e@e...e@.ee.....@e@..
w.@e@e@@e.e@.e@.....@ee@@e.......e.w
..e.e@ee@.....e@e.e@e@.e.e.e.e@e@e..
.....e@...........e..e.@e@.@e.ee....
w.....@e..e@......@e@@e@@e..e..@e..w
...ee@e....e..e.e@e.ee@e@@.e@e@eee..
...@e..e@...e@@.....e@..ee...@.e@@..
w.e.@e.@e@e.@ee@.e@e@........e.e@e.w
..@e....ee.e@@eeee@e..e@ee@e.@ee@e..
..ee....@@..e@e@@e@@e...e@...@e.....
w.@@....ee@e.e@.e@e@e..e@..e.e..e..w
..ee@.e@..e..@ee@@ee...@e.e@...e@...
...@e..e.e@e@..@@e.@e@e@e.@e...@e...
w....ee@@e.@e..ee.@e.e.e@.......e..w
....e@..ee@e...@@ee....@e....e.e@...
........e@@ee@ee.e@e........e@......
w.@e..ee@ee@e@e@.@e@ee@.....e@e....w
..ee@e@@.@ee@@e..ee@@@e........ee...
....e@.e.....e.ee@@eee@..ee..e@@@e..
w...@@ee@@ee@..@e@@e..@ee@@..eee...w
....ee..ee@.e.ee.ee@..e.e@e..@e@....
.........e@e@.@e.e@e..@e.@e.e@ee@e..
w....ee....e..e@.e@@.e.e@e...@ee@..w
....e@@e...@......eee@e@@e...e..e@..
.....e@e.@ee..ee....@e@.e@.......e..
w...ee@e.e..e.@@ee.........e@e.e@e.w
..e@@e@..@ee@eeee@....e@e@ee@.......
..@ee.ee@ee@.ee@@e....@e.e@@e.......
w...e.e...@ee@..e@..e.e...ee@......w
....@e@...e@e@ee@...@e@e@e@.........