33,36
359
359
1000
...e@e@e......@e...e@@e@e....@e@e...
w.......ee....e.....eee@....eee....w
...e...e@@..@e..eee.@e.e...e@@@e....
..e@@e.e@e@.e@e@@@@e....@e..@e......
w..ee@....e@e@@eee@e..@ee@e@e..@e..w
...@e..@e.e@ee...e@e..e@e..e@e@ee@..
..e@@e.e...e@..e@@e....e@...e@e.ee..
w.@e.@e..e@e@e..ee@...e.e@e@@..e@..w
..e...@e@ee@@eee@.eee@@.@..ee@.@e...
..@e.ee...@eee@@ee@@.ee@e...ee.ee...
w.e.e@@e.....@ee@e.e........@@e@@..w
..@e@e@.......e@e@e..ee..e@ee@.@e@..
..ee@.e.e@e@ee@@e.@ee@@e.@e@.e.e.e..
w...e.ee@e@..e@e........e@e@...e...w
..e@e@@@ee@..ee..e@.e....@ee..e@....
...e.eee@.e@e@@..@ee@e@.@e.......e..
w.....e@..@e..e...ee@ee.e...e.e.e@.w
..@e...@e....e...e@..@ee@.ee@.@..e..
..e....e.e@e.@..e@ee...e.e@e..ee.@..
w.....@ee@e@.e..@ee@..e@.@....e@ee.w
......e..ee..e..e@.@e@...e..e.e@@...
...e.e.e@@@ee@..e@.e.e.....e@e.ee...
w.e@e@..eee@....@e.@e@e@e@e@...e@e.w
..@e..e@@e.e@...ee@e.e@.ee.......@..
..e....e@e.@e..e@e@@.@ee@@e......e..
w.@....e@e..@..@e.eeee@@e@@ee@e....w
..ee@e@e@e..eee@@..e@@e@ee....e@e...
......e.@ee.@@eee@e.ee.........e@...
w.....@.e.@ee.@..e.e@.e@@e.e..@e...w
...@e.e..e@e..ee@@..e@.ee.e@@ee.....
..@e@....e@e@e.@ee...e.....ee.@e.e..
w.ee..ee..e.e@.e@....e....e@@...e@.w
..e@.e@@e...e@e@e....@e...e@e.......