33,36
363
363
1000
......e@ee.e@.ee@@e@e.@e@ee@.ee@e...
w.e..ee@e@eeee@@ee....ee@e.e.@@....w
..@ee@@e..@@e.........e@ee.@.ee.e...
...ee@e...ee@.....e...ee@@ee..@e@...
w.e@.e@..@e.e.e...@e@.@e...@@e.....w
....e@@e.e..@.@.....e..e@e.ee@......
....eee.....e.e.e@ee@e.@e.e..e@e@e..
w...@@@ee@.........e.@ee..@...e.e@.w
....ee@e.e...e@....@ee@@..e......e..
.....e@@e.....e.e@e....e.......@e@..
w.....e@e.e.e@...@e....@e@ee.e@ee@.w
..@e@e.@ee@e.e...e..ee.e.@e@.@...e..
..e.@e.e@e@@e@.....e@@...e..eee.e...
w...e.e...e@e.e.e@..ee..ee@.@@@e@..w
....ee@...@ee@@@ee@e@e@e@.e@ee@@e...
..ee@.e.e@@e.eee@@e@e..@ee...@ee@e..
w.@..e@.@ee...e@e@..@ee@e@e@e...e@.w
..e.ee@e@.e..e@@ee@...e@..@e.e......
..ee@@e.ee@....e@.ee@e.e.e@.e@......
w.@@e.e@.e@e....e@@e@e....e........w
..ee..@ee@@e.e..@ee@e....e@.@e......
..e@......e.e@.e@@e.@e......e.e@@e..
w.........@e@e..e.@e@e@@e.ee...eee.w
....e....@e..@e..e..@eee.e@@e.e@e@..
..e.@e@e@ee@e.e..@eeee@.e..@eee@e@..
w.@@e....e....@.e..@e@@e@.eee@.e.e.w
..ee.....@e...ee@e.e@.e...@ee.e@....
...ee@@ee@@......@eee.@@e..@@.......
w.e@@ee@.ee@@e....@@@eee...ee......w
...@e.e@ee.ee.@e..ee@e.e@e@@ee@.....
...e..e..@e@..e.....@e..e.e.@@e@e@..
w..eee@@ee@@e...e..ee.e@ee..e.ee.e.w
..e@@e.e@..e@..e@..@e..e@@e..e@.....