33,36
358
358
1000
.......e@e....@e.@e@ee...@e.e@@e....
w..e@ee@......e.@e.ee@e@ee@.@ee@@e.w
....e...@e.e@...e..e@...@e@e..e@e...
...e@e@ee@e.e.e@@e.e@@e.ee@e@.@e....
w..e@ee@e@@e@..e....ee..e@.@eee@...w
....e@@e.e.e@@e...e@e.ee@...e@@.e...
..e...e@.ee.ee.....e@e@@..ee@.e.@e..
w.@@ee@@e@@e.e....e..@eeee@e..ee@..w
..ee.@eee@e.e@@e@.@e@e.@@ee@@e@@ee..
..@@..e@@e@...e.e...e@.e@.eee@...@..
w.ee..@ee..ee@..........ee@@e....e.w
..@...e@@e.@eee@e........e@@e.......
..e.@e.e@e.....@e@.@e..e@eee........
w...e@...@e..e@e.e@e.e.e@.e@...e@e.w
..e........e.......@e@@ee..e...e@e..
..@e.......@e..e.e@.e@e...e@.e..e@..
w.e@.ee@ee.e@e@@..ee....eee@e@.....w
...e@@ee.@...@ee@..@e@ee@@..e@ee@e..
....e@e@.e.....ee....e@@.e..e@@.@e..
w.ee@@e........@ee@e...e.@...eeee@.w
..@e.e.........e@.......@eee.@.@....
..@ee....e@....e...ee.eee@@@ee.e.e..
w.e.@e....e...e@...@@e@@@ee.@e...@.w
....e@...e@@ee@e...ee@.e.e@.e@...e..
...ee.e....e..e@..e....e@e..@e@e....
w.e@@.@.e@ee@e@e..@e.e.ee@..e.eee..w
..e@e.e.e@e.e@...e@ee@e@e@..e.@@@...
...e@....e..e@ee.@e.@e@e@e..@.eee...
w..@e....@e.@e.@e..e@e@e.e@ee......w
...e@e@ee.e.....@e.ee.@e@eee@e......
...e.e.e@e@.e@e@e..@@ee@.e@@...e@...
w..@e@@e@e........ee..e@e@.e....e..w
......ee@e..e@e..e@@e......e@e.e@e..