33,36
356
356
1000
.....@e.e@ee@@ee@....e@ee........e..
w.e..e.....@ee..e...e.e@@e@ee...e@.w
..@e.e@e.e@e.ee@...e@.e@@e.@@e...e..
...e@e...e..e@@e.e....@eee@ee@..e@..
w...@e...@e@e@e@.@e..ee.e.@e...e@..w
..e.e@....@e....e@@e.@@e@@e.e@e.....
..@.ee...e.e@...@e...eee@e..@e@.....
w.e.@@e.e@..e........e@.e@eee...e@.w
..@ee@e...e.@..e@......e@.@@ee...e..
..@e@@e..e@.e...e....e@e@.e@.@e..e..
w.e..e...@ee.e.....@e.e.e..e...e.@.w
.....e...e@@e@....@ee@@ee@....e@.e..
...e@@e......@e...e..e.e.e@.........
w...e@e.e....e@e@e@..@e@.ee...e....w
.....@ee@e@e@@e.e@..ee...@.@e@@e....
...@eee@@ee@ee@....e@@e@ee.e.e@ee...
w..e@ee.ee@..@eee.ee.e@@e..@e..e@..w
.....@@.e@e.e@e@@e@@.@@e.e..@e.e@e..
.....eee@e@..ee@e@ee.ee.e@...@ee@e..
w....@@e@eee@@..e@@.....e@e@e...e..w
..e..e....@@ee@e.eee.....e..e@.e@e..
..@e@@e...e..e@....@eee@e@@e@e.e@@..
w.e.e..eee..e@e...ee@@.@eee.....ee.w
..@e..e@@@ee@.....@@ee.ee@e@e..@e...
.....e..ee@@@e..e@ee@@@e@ee@@e.e....
w..e@@...eeeee...e@..ee.e@@ee@.e.e.w
..e.ee..e@@ee@...e@.e@.e@....e.@e@..
..@e.....@e@......e....e@e...@e.e@..
w.....e@.ee.......e....e@e.e@ee..e.w
..e@ee.e..@e..e...@e....e@.e@e@e@e..
..@e@@e@..ee@e@@e@e@@e..@e@....@e...
w......@ee@@e..eee.ee@..e.e.....@e.w
..e@e..e.e@e.e@e@.e@....@e..........