33,36
361
361
1000
..@e@e.e@ee@e.......@e..@ee@..e@e...
w.e........e@...e...ee..ee.e.e@@e..w
..e.e@e.@e.e@e..@e..e@.e@@e.e..e....
..@.e@e.e.e@e@..@e..e@e.e@@.@.e@....
w.e.e@e@@e......e..e@....ee.e.e@e..w
....@e.e@..e.e.ee..ee...ee..e@..@...
....e...e@e@e@e@@ee@@e.e@@...e..e...
w..e@@ee.e.@e@e...@e@.e@.e...@.ee@.w
.....ee@...e@.e.....e.@@e@...e@@ee..
...@e.@ee@e.@e@...@e@.ee.@e..@e@e@..
w..ee....e@ee.e...e@.e@.ee....ee@..w
....@.....e@..@ee....@e.@..@e.@@e...
....e.@ee.e@e@e.@eee....e@ee..e.....
w.e@..ee@.@e@@e.e@@@.e@ee@...@e..e.w
...e...@e.ee@e.e@.ee....@e...e@.e@..
..@ee.e.@e.e@@e...@...eee...e@..e@..
w.e.@e@....@ee@.e@e@ee@@@e...e...e.w
..eee@.e@.....@e...e@e@ee...e@e.....
..@@@@e.e.....e@.e@e.e@e@@ee@e@.....
w.eeeeee@e......e..@e.ee@e.....@e..w
...e@@@@@ee@e@ee@......@ee@e...e....
...@@eeeee.e......e@e@e.............
w..ee....@.@.......e@e......eeee.e.w
...@e....e@ee...ee...@.e...e@@@@e@..
..e.e@e...e.@@e.@@..eee@e..e@ee@e@..
w.@e@e@e@.@eee..ee@e@.ee@.....e..e.w
..e..e@eee@@e.....ee@e@e@e..ee@.@e..
..@e..@e..e@@....@e@e.e@...e@@@eee..
w.ee..e....ee@eeee....@@e...@eee@@.w
..@@e.@e..e@@@e@@e....ee...eee@..e..
..e@.e@...@.ee...e@e......e@..e.e@..
w.ee@.e..@e@.@e.@ee...e..e..e.@..e.w
..@ee.@e.e.e..@eee@e@e@..@e.@ee.e@..