33,36
348
348
1000
..e@e.e.ee.e@e@e@@ee...........e@...
w.....@e@@e..ee.eee@.e@e.......@e..w
...e....@e..e@@e........e@e..e..e@..
...@..e@e@.e@@eee.....e.ee..e@.e.e..
w..e@e@....e@ee@@.....@e@@e.@ee@e@.w
...@e@...@e..e@@e@e@e.......e@......
..@e....ee...e@e....@....e..@.@ee...
w.e@.eee@@.@e@@e....e....@e@e.e@@e.w
.....@@e@e.e@.e....eee@...ee@.......
..e@ee.@e..@e.e....@@ee.e@@e..e..e..
w.e@@e@e..e@..@.e..ee@...e@...@.e@.w
...e.e.....e..ee@.e@@e....e...ee@e..
...@e@@e@...e@..eee@e.e.............
w..e..e.ee...ee.@@e@..@@e.......e@.w
....e..e@@e..@@@eeeee.eeeeee.....e..
...e@..e@e..@eee@e@e@e@e@@@@e....@..
w......e@e..e.......e@e.@ee@e....e.w
..ee@e.e@ee@e.eeee..ee@.e.e@e@e@e@..
..@ee..e@@ee..@@@@ee@e@@e.@@e@e.e...
w.e@@e.@e@@@e@eee@ee@@ee@.ee..@.@..w
.........eeee@e..@eee@..e....@e@e...
.......e@e@......e.@ee..@.e@@ee@e...
w...e@e@...e@e....e..e..e..ee@e@e..w
.....e@...e@..@e..@e@@...e@ee@e.....
...e.@...e@.e.e..e@eee@.e.....@ee@..
w..@.e..e@@e@...@e@e@.e@@e.e@e@e.e.w
...e@..e@.e@....e..e@eeee@..e@ee....
....e.....e@e@e....e..@.@e...e@@ee..
w...e.e....e...e@e.@..eee@e@e@..e@.w
...e@.@e@......e@..e@e.@e@eee@e.....
...@e@e.ee@.....e@e.....e@@.@ee.....
w.e@ee@e@.e@ee..@e..e...@eee@@@ee..w
......e@....e@.e@e..@e....@eee.e@...