33,36
361
361
1000
.....e@...e@e..e.e@@ee@@e@..........
w.e@..e..e@@e@e@.@eeeeeeee.....e...w
..ee.....e.e@e.@ee@.@@e.@e.e...@e...
..@e.....@.e@@ee@e@eee@...e@..e@e...
w.@e@....e..e@...e@.@e@e....e..e@..w
..e.e...e....ee@..e@e@...ee@@..e....
.....e..@ee@e@.e@..e....e@@eee.@e...
w...e@.....e...@e...@ee@ee@.e@@e...w
....@e.e@e.@e...e@e.e....@eee@e..e..
...e@.....ee@@e..@ee@..e@ee@@ee..@..
w...e.e..e@@.e...e.@e.e.e@e@e@@..e.w
......@e@@@e..e@..e@@e@..e.e.@e.....
...e.e.eeee@.e.e..@ee@.e.@e..ee@....
w.e@.@e@..@e.@e..e@e...@e@e....e@e.w
...@e@.e.e@e..@e.e@@e..e@@e.........
...e.e.@ee@.e@e...ee@.e@.ee.ee@@e...
w...ee.e@.e.ee@.e.....e@e@@.@.eee..w
..e@@@e@..@.@e@.@....ee@e.e.ee.e@e..
..@ee@e.e.e@e@e@e..e@@e..e@e@@ee@@..
w...e@ee@e.........@e@e..@e.ee@.ee.w
..eee....@....ee@e.....e...e@e@e....
..@@@e.e.e....@@e...@e.@e@.....ee...
w.ee...@.@....e@....e.@e@e...@e@@e.w
....e..e@e....@e.@e.e@e..ee..ee@e@..
..e@@............e..e@@.e@@e@e@e....
w.eee.ee....ee.......eeee@e@e@e@...w
..@e@.@@e..e@@...e..ee@@ee......e@..
...e@.e@....eee@e@.e@...@e..e@e..e..
w.@ee@ee..@e@....e..e@@ee@e.e@e....w
..e@.ee@..e@...e@ee@eeee.e@..e......
..e..@ee.e@@e@e...@e..@@e.@ee@...e..
w.@e.e@@ee.e.ee...@eeee@e.e..@e..@.w
..e.e@e..@e.e@@e..ee@@e.e@e..e...e..