33,36
363
363
1000
...e@ee@e@e..e.e@.e@@e@ee.....@ee...
w..e..@e....e@.ee..ee.e@@e...ee@@..w
..e@..e.......e@@....e@ee@e@e@..e...
...e..@ee@e@e...e.....e@...e..e@e...
w..@e.e@.e......e@.e..e@.e....@e@..w
..e@e.....@e@....e.@ee.e@@e@e.......
..@.e@....eee@..e.e.e@..e.e@........
w.e@@e.ee.e@ee.e@e@e@e.....e....e@.w
...e..e@@.@.@e.e@.e@@e@e..ee..ee.e..
...@e.e@e.ee@ee@e.e@ee@@ee@@ee@@@e..
w.e@e.@eee..ee.e@e@@e.e.e..e@@eeee.w
..@e@e@.@@@e@@e....e.@e.@.e@e@ee@@..
..@e.ee.eee.e@.......e..e..@e@e..e..
w.e@e@......@e...e@e@@e@...eee@....w
....ee..e.e@e@e..@e.e..e@ee@@..e@e..
..ee@@ee@e.e.e@.e@ee@@e.....eee@....
w.@.e@e@@e.@ee@e..@e.e......@@@e@e.w
..e..e@.e.e@e.e@@e.......e..ee..e@..
..e.e@ee...e@...e.e.@e.ee@e..@e.@e..
w.@ee@@@.e@e@@e..e@.e@e@@@e..e@e@e.w
...@@eeeee@eee.e@.e@@..eee...@e..e..
...e@...@e@e@e@ee..ee.e@eee...@e.@..
w.e@ee@eee@..@@e.e....@e@@@e...@ee.w
....e.e@e@e..ee.e@@e.e@..e.....e@...
...e@..e@.e.....@.e...ee@@..........
w.e.e@e..e@.e@@ee@@e.e.@ee...e@e...w
..@e@@e......ee..e..e@.....@ee.@e...
..@e@e.ee@e...e@e@.e@@e.eeee.@...e..
w.e....@ee@..e@.@ee@.ee@@@@@.e..e@.w
...............e@@e@e@eeeeee...e@...
................ee...e@@e..ee@e.....
w.............e@e.e.e@e....@e......w
.............e@...@e.e@....e@e@e....