33,36
371
371
1000
......e@ee.e@@e...e@@e@ee@.e.....e..
w.....e@@@..ee.ee..eee@e@e.@e..ee@.w
..e@e..eee@e...@@..@e@...e.@ee.@ee..
....e@e..e@....ee........@ee.@ee.@..
w.@e.e@.e.e.e@e.....e@e.e@e...e@.e.w
..e..ee.@e..@e...e@.....e....@e.....
..e.e@@e@e@e...e..e..e.e@e.e@e......
w.@eee..ee..e@e@.....@e@..e@@e@e...w
..e@@@.e@@e@ee.....eee....e.e.e@@e..
....ee..@ee@e.@e..e@@@e.ee@...@ee...
w.e@.e@ee@@e..e...e@e@..@e@e.@e@...w
...e.e@e..e@...e..@e.ee@e.@eee......
..e......e@.e.e@e.....@e..e@@.@e@e..
w.@..e@e.e@e@e@e@.....e...e.e.e.e@.w
..e.e@e@.@@eee@ee.....@...@e..e@e...
....e@e..ee@@e..@e...eeee@.ee@e@....
w.e.e@.@ee@e.e.e@....@e@eee@.e@e@..w
..@e@e.ee@e@.@e.eeeee@.e@ee@e...e...
..@ee@ee.@e..@e.e@@@eee@e@@@eee.....
w.e..e@@.ee..e...@e@e.@...eee@@e@e.w
..e..@.e..@ee@@e@ee@e@e.e@ee........
..@..ee@....@ee@..........e@.@e..e..
w.e..@@e@e....e@..e@e....@e.@e.ee@.w
...e@e.e@@.e...e...e@e...e..e@.@.e..
..e@e...ee.@e..@e.e@e..@e...@e.ee@..
w.@.@...e@.e@..e@.@..e.e.....@e..e.w
..e.e..ee@e....@..e@e@e@ee..e@.e.@..
..@.ee@@..e.e..e@..e..@.@@ee.e@@ee..
w.ee@.ee@e@e@..@e.....eee@e@..eee@.w
...........@e..e....@ee@..e@e..@ee..
..........e@e..@@ee.e.@e@e@@ee@ee@..
w....e.e.......eee@@e.ee@e@e.e@@e@.w
....e@e@....e@e..e@e..@e..e@..ee.e..