33,36
360
360
1000
..@e.e@e..e@e@...ee@...@e@e@@e...e..
w.e.e@..e@@e.ee@.@ee...e.e.ee....@.w
..@e.....e@ee@@e.e@@@e.@e..e....ee..
...e@@e...@e@e@e@@.ee...@..@...e@@..
w...ee....e..e@.ee.e@e..e@ee@e...e.w
..ee@e...ee.e.e..e..e@......e@......
..@@e...e@@e@.e..@e.e@e.........e@..
w.ee@e@e.ee@.e@e@@ee@e...........e.w
..e....ee@e@e@e@eee@e@....e@e.e@....
..@e...@.@e.@ee@.e@..@e.e...e..eee..
w......e.ee@e@.e....ee..@e.e@..@@@.w
....@e.@ee.........e@@e..@e@@e.eee..
...@e@.ee@...e@..e.@.e@e@...e.e.@...
w..e...@@e.e..e@.@.e@e..e..e.e@ee..w
..e@ee.e@.e@.e.e.e.ee@.@ee@@e@e@....
..@e@@e.e.@e.@e..e.@e..e..e.e.......
w.ee@e...e.@....e@e@e@......@e.....w
..e....e.@ee...e.....e.....e...e@e..
..@e...@ee....e@e..ee....@e@..@e@@..
w.@e...e@@e.e.@e@@e@@e...e.e@ee.ee.w
..e.e@e@e@e.@ee..e..e@e....e.e@.@...
.....e@.e.e.@e.....e@.....e@.e@ee...
w..e@..e@e@.e@....e@.e...ee.....@..w
...@e...e@e..@e...@e.@.e.@@.....e@..
...e@e..@.@e.e..ee..eee@@ee.e.@e.e..
w.e@.@e.e@e.e@.e@@..@ee.ee@.@eee@e.w
..@.ee@.@e.ee@e.@e@e@e@..e@ee@.ee@..
..e.@@e.e@e@..eee..@ee@e.....@e@....
w.e.e@.e@...e.@@e..e@e@@e@.e@e.@e..w
..@@ee.@ee@e@ee@e.....e@ee.e...e....
..ee....e.e@e@@e@...e....@e@eee@.e..
w..e@e.e@e@...eee.e@@@e..e..@@@ee@.w
..e@e..@e.....e@@e.eee...@e.ee@e....