33,36
361
361
1000
...e@e@ee@eee.e.....@e...@e.@e.ee@..
w..@e.....e@@e@.e@@eee@e.ee@e@.@ee.w
..e....e..e.@e@e.ee@e@e@.....e......
..@e@e.@.e@.e..@e@.e@@e@e@..e@e@e@..
w.e@..ee@e.e..e@e@..@e.@ee.e@e@..e.w
..e@..@e@e.@e..e@e..e..e..e.....ee..
...e.......@e..@.e@e.e.@e.@e....@@..
w.e.e..@e..e..@e.@e..@e.@e..ee@eee.w
..@e@e.e...e.@e....e.ee@..e@@e......
..@e@@e...e@ee..e..@e@@e@e.e@e......
w.e.ee@e@e@.@..e@..e@@e....@.e@....w
.....e@ee@..e@e@e@eeee...e.e@ee.....
..e@e.@e.....e..e@e@@e@ee@...@e.....
w....@ee@e.......e..e.@ee@e@.e.....w
.....ee@e@....e.....e@e.e@eee@.e@e..
......e@......@..e@e......ee........
w......ee...e@e...e.....@e@@ee.e...w
......e@@e..@e.e@e@.e@e@ee@@e@.@....
...e@e.e@e..@e......e@e..@ee.e.e....
w..ee..e@@..e@...@e..@e......@e..e.w
...@@e..ee@e....ee...e@@e.e@e@e.e@..
...e@e.ee.e@...e@.e@e..e..@@e..@e...
w....e.@@e@e@@ee@....e@ee.ee...e@..w
.....@eee@@eee..e....e..@e..........
....e@e@..e......ee..@..@e..e@e..e..
w....e@ee..e@.e@e@@e@e..e@.ee@e..@.w
..e....@@eeee...@e@e.....e@@e@eeee..
..@e...e.@@@@e@e@.@e@e.ee@e.e@.@@e..
w......@eeee@eeee.ee@ee@@e.@ee.ee@.w
...e@eee.e@..e@@e..e@e@e@@ee@e......
...e@.@@e.....e@ee@e@...e@eee@......
w...e.e@@@e@ee@e.@..e@..ee@@e@@e@e.w
.......eee....e@.e...e.e@e@e.ee.e@..