33,36
354
354
1000
...e....e@......e@e.e..e@ee@e.......
w..@e....e...e......@...ee@.@e@....w
...@ee....e..@ee....e....e.e@.e.e@..
...e.@e..e@e..@@...ee...e@e@e...@e..
w..e..@.e@@e..ee.@e@@e....@e@e.....w
...@..ee@@e@@e@.ee.e@e...e@ee@e.....
...e.....ee@e..e@...@e...e@e@.......
w..e@e....e@.e@e@e..e.e...e.....e@.w
....e.@ee@ee@.@ee@.e@e@ee........e..
....@.ee@e..e@e.e@e.e@.@@e..e@e@e...
w...e...e@e.e..eeeee@..e..e@@......w
....@e..e@@e@.e@@@@ee@e@...eee@@e...
..e@e@.e.e....@@ee........e...eee...
w.@ee.e@@e.e@eee@e@..e.e@e@.@e@.@e.w
..e@@e@.e..@@e.e..e.e@e@e.@ee....e..
......e.@..ee@.@e...@e@e@ee....ee@..
w....e@.e.e.e@.e@..e@eee@@....e@e@.w
.....e....@e@e.e@ee@@e@@ee......@e..
..e.e@.....ee..e@.e@ee@@e..e........
w.@ee@ee@e@@.e@@e...eeee.@e@e@.....w
..@e..e@.eee.ee...ee@@...ee@@e......
..e.e@@ee@@@.@e..e@e@e....ee@e@..e..
w.@e.e@e@@eee@.e@..@ee....@.e@e..@.w
...@e.e..e...e..e....@..@eee@...@e..
...@e.........@e@e..ee.eee.@e.e@e...
w..e@.e.e@e@e.e..@@e@@e@e@e.@e.....w
..e..e@.e@e.....@ee@e@@e@e.ee@e.....
..@ee@ee@.e@.ee.e....eee@@e@@e.@e...
w.e.@e@.@e@e.@@@e.e.e.eee.e@@e@e@..w
..@.e...e.@e@eee@e@e@e@@e.@ee@......
..e...e@@@e..@e.eee@....@e@e........
w.@e...eee....ee@@e...e@..e@....e@.w
..e..........e@....e@e.e..e@e....e..