33,36
355
355
1000
...e@@eee@ee.....e@e.e@e@.....e@e...
w...ee@@e.e@.......e..e.e..........w
..e@e..@ee@....ee@e@.e.ee@..@e.e@e..
..e@...ee@e..@e@@ee@e@.@.ee.e..@e@..
w..e.e...e@..e@@ee@.e@eeee@...e....w
....e@..e......eeeee@@e@@e@.e@@e....
.....@e@@e......@@@e@e..eee.@ee.....
w...ee.e....e...ee@.....e@@..e@.e..w
....@e@e...e@..e@.e@..e@e@e.e..e@...
...e@e@e@e.@@e.ee@eee@@@e@@e@.......
w.e@e@@e...ee..@e@@eeeee@e@.e@ee@e.w
..@@e.eee.....e..e.e@@@.e.e..@e..e..
..ee.ee@@.....@.@e...eee@....e..e@..
w.@@.@e.e.....e@e.....e..e@ee...e@.w
..eee.@e@.....e@e.@e.e@@ee@e@e@..e..
...e@ee@..e@e.@@e@e@.e@e.....@e.e@..
w.e@@ee@e..e@eee.....@ee...e@....e.w
..e@e..e@..@e@.e.e@e@ee@....e@e..@..
..e@e.........e@e@e@@e@e....e....e..
w.......e.....e@e..@ee.@e...@e.....w
..e...e@@e@...e@e..e@@.........e@...
..@e...e..ee@....e.e@e.........@e...
w.e@.e....eee...e@....e.....ee@e@..w
..e@e@e@@e@@....@..@ee@..@e.@e@e....
.......eee@ee...ee.e.@ee.e@.ee@@....
w.e...eee.@e@...e@..ee@@....e.ee...w
..@e@e@@@.ee@e..e@@e@@ee@ee@@e@..e..
..e@ee@eee@e.e@..eee@@e....e.@ee@@..
w....e.e@.e@..ee@e..ee.eee@@e.@eee.w
.....@e@e.e@e......e@ee@@ee...e@e@..
....e@ee@.e@@e....e@e..e@@@e.e@e....
w.......@e.e@e.e.e@.....ee.@e.e@...w
........e@.e@ee@.@e....e@.....@e....