33,36
363
363
1000
...e..e.e@e@e@@e...@e..e.e@e.@e.ee..
w.e@..@ee..e.ee.e..eeee@.....ee@@@.w
..e..e.e@e.@e@..@..e@@.@e..ee.@eee..
..@.e@@e.@ee@ee.e...@e.e..e@@e......
w.e.e@e@....e@@e@..ee.e@.e.e@@...e.w
...e.ee@e..e@.e....@e.@e.@e.ee@ee@..
..e@e@..@e.@ee@.eee@..e@@e@..e@ee@..
w..e@..ee.e....e@@@e@e@@e....@@e.e.w
...@.e.@@e@ee..@ee...e@e.e@e.ee.....
..eee@.e.e@@@ee@e...e@e@..e@........
w.@@...e..ee@...e@ee@.e..e@@ee@e@..w
..ee@.e@....e@e..e@@ee@e.@ee@.e.e...
...@e..ee.....e..e@e@@e....e@ee.....
w.ee@e@@@e....@..e@.......e@..@e@e.w
..@e..ee@e@...e...e.................
..e@......e.......@.e@.e.e.e...e@e..
w.........@e.eee..e@@e.@e@e@....e..w
......@e....e@@@..@ee...@@e@e@.e@...
..e...e.....@eee..e@@ee@eeeeee.e....
w.@ee..e....e..e@.@.e@.e@.@e@.e@...w
....@.e@....@ee.e.ee@@e@..e....e....
....e.e@ee.e@@@....@ee.e@e@e..e@....
w...ee@.@@..eee@e.e@e.e@e..@e...e@.w
...e@@@eee....e....e@e@@e@e@e@...e..
...@eeeee.e@ee@.....@e.e...e@e......
w.e@e.e@@e.e@.......e..e@..@e......w
..e@e.....e@e@e...@e..eee...e.e.....
..@@ee...........@e..e@@ee@e@e@..e..
w.ee.@....e@e@e..ee..e@@ee@e@e..e@.w
..@..eee@.ee@.e.e@@..eee..ee@eeee@..
..e..@@.ee@@.e@.@ee@e@e....e@.@@ee..
w..e@eee@@@e.e@e@.e@e@@.....e.e@e@.w
.......e@ee..e@ee.e@eee..e@e...e....