33,36
357
357
1000
..e...e@@e...e@e.e.e@.e@@e......e@..
w.@ee@@eeeee@e@..@..eeeee.@ee....e.w
..@e.e.@e@@.@eee@e.e@@@e..e.@e@ee...
..ee..e@e@e.e@..e....e....@.e@.@@e..
w..@..@.e@ee@...@..@e@.e..e..e.ee@.w
...eeee@..@e.ee@e..e.e.@e.@e.@e.@e..
...@@@ee.ee.e@e......@..e@..........
w.@eee@..@@e@@e...e@.e...e@...@e...w
..ee@...ee@e@e.....e..ee..ee..e.....
..@.@e@.@e@...@e......@@e@.@....e...
w.e.e.e.e.e...e.@e.e@.ee.e.e.e..@e.w
..ee@ee..e@@e...ee@ee@......e@e@e...
..@@.@@e@e.e@e.......e......e@e.....
w.ee@e@......@e@@e.......e..@e@e...w
..e@..e@...e...ee@..e....@ee.e@@e...
...e...e.e.@..e@e...@...e..@@ee@ee..
w..@@e...@ee..@e.ee@e..e@e.ee..ee@.w
..@eeeee@e@.ee@@e@@ee@e@.@e....@e@..
..ee@@@ee..e@.ee.@e..e.....e@....e..
w.@@ee@....e@..e@e...@e...@ee.e@e..w
..e..@e@e...e..e@e..e@e...e@..@.....
...@e......e..ee@e@ee@@e@.e@.ee.....
w.ee@e@e...@e.@e@e@e@e.@eeeee@@ee..w
..@@@e.e@..@e..e.ee@...ee@@e...e@...
..eee@e.e.@e@..@e@@ee..@..@ee@e.....
w...e@@e@.ee@...e@@e@e@e..e.e@.....w
...eee.e@e..ee...ee..........e......
..e@@e.@ee..@@.....e@ee...@e.....e..
w.e@e@.e@@e@ee.....@e@@e.@e....e@@.w
..@e.....e@..e...@ee..e@.e...e..ee..
...eeee@ee@e.@e..e.@e@@...e@e@.e@...
w.e@@@eee.e@......@e@ee.ee..e@ee@e.w
....e.e@@e........ee@e@e@@e.........