33,36
364
364
1000
...e..e@e.....@ee@e...e@..e@..e.....
w.e@..e@......ee...ee.@e...e.e@.@e.w
..e@...ee..e..@@e.e@@e.@e@e.....e@..
...e...e@e.@eeee..e@ee@ee@..........
w.e@ee.e@@e..@.@..@e.@e@.e@e.......w
..@e@@e.e@..@e.e...e.e..ee@e.e@e....
..ee@e..ee@ee@e..e.@ee.e@.@e...@e...
w.......@e@..e@.e@.e@@e@..ee@.@e@..w
.......@e.e.....e@ee.@e@e...e.e.e...
..e....e..e@.....e@@.e.@e.e..e.e@...
w.@.......@e.....@eee..e@.@e@@e@@e.w
..e.e..ee....@ee@@e@@e.@.e@ee.e@e...
..@e@.e@@...ee@.ee@e@e.e..@e.@e.....
w.e.....e@@e@@e@e.e..@e@e.e..e...e.w
......@e.eee@@e@e.@e.e@@e@.e..e.e@..
...e..e.....ee.@e..e@e.e.ee@e@@@e@..
w..@e@e......e@e.ee......e@.@eee@e.w
...ee@e..e.e@e..e@@e.e@e...@e@@ee...
..e.@e..e@.e@e...@ee@e.@@e.ee@.e@...
w.@e...e...e@e..ee...@eee.e@.e@....w
.......@e@e..e@e@...e@e..@e@eee.@e..
......e@@e@@e.ee@e..e@e.ee.@e@@@e...
w......ee..e...e@e@e....@e.e..ee...w
.....e@e.....e.e.e@@ee@ee.e....@e...
......@e.....@e@..e@e.e@@e@@e.e@e...
w.....e@.e..e@e@e@e..e.e@e.e..e@e..w
.....@ee@@e.@e.e.....@e.e@..e@e..e..
...e@e..e@e@@e.e@e..e@e......e@e@@..
w..e...e@.@ee@@e....e@eee@e@e@..ee.w
...@e..@e@e...e.@e..@e@@e@e.@e......
..e@eeeee@@e.e.ee....e@@e@@ee@...e..
w..@e@@e.e.e.@e@.e@e..ee.e.@ee.ee@.w
...e..e@.@e@..@e...e@e.....e@@e@ee..