33,36
368
368
1000
..e@@e....e@e..e..e@e@e@ee....@e....
w..ee@e@e@e....@.e.eee..e@@e..e....w
...e.e@........e.@.e@ee@eee.....e...
..e@e..e@...e..e.e.e@@e.e@.....e@...
w.@eeee.e..e@.e@..@ee@e.@e..e@ee@e.w
..e.@@@e.e@ee.....ee@@ee@..e@.e@@e..
..@@ee@e.@e@@e.....e@e@.e..@e..@e...
w.ee..e.e@e@ee@.e..e@e@e@..e@.ee@..w
......@ee@e@..ee@...e.e@eee@e@@e....
.....e@..@eee..@e.....e@@@@e.e@.....
w.e..ee@ee..@e.e@..e@e@eee@ee.e@e..w
..@e.@e@e..e@ee......e@e...e@e@e....
..e@.e@@e...e@@..e@e@@.ee@.e@@......
w...e@@ee.....e.....ee.@ee.@ee@ee..w
...ee@ee@....e@....e@.e@e@......@e..
..e@e@@@e.......e@e@e..e@.....@ee@..
w....ee.@e@ee@.e@e..@e.e@e.@e.eee@.w
...@ee@.ee@eeee@e......e@e.e@..@ee..
...e.e@eee@e@e@@e@ee@...@ee@e.e@e...
w..e@ee@@ee@ee@ee@eee...e.@@ee@e...w
.........e@..e@e.@e@e@e@e.ee...@e...
.........e.e..@eeeee@e....e@....@e..
w......e.@e@.eee@.@..@e....e@......w
...e...@....e@@@@ee@e.e@e@e.ee......
..e@e@.e.@e...eee...@e...e@..@......
w..@eee@.e@.e.e@...e.....@...e..e..w
...e@..e...e@.@e...@e..eee.ee..e@e..
...e@e@@@ee@...ee.....e@@ee@@..e@@..
w.....eee@....e@@e....@e@e..ee..ee.w
..e@e..e@....e@@e..e.@e....ee@..@e..
...e@....ee...@e..e@@ee@...@e...e@..
w..@ee..e@@ee.e...@ee.ee....@e@e.e.w
...e@@e.e@ee@....e@e@e@.........e@..