33,36
368
368
1000
....@ee.e@ee.e@e....e.@ee@@e@...ee..
w...e@@..e@@e@..e..e@.e.eee.e...@@.w
.....ee@e@ee....@e....@.@e@.@e@.ee..
...e....e@@@e..e@e@e..eee....ee..@..
w..@.....ee@eeee@@ee@..@...e.@@e.e.w
...e.e@@e...e@@eeeeee.@e..e@ee.@e@..
......ee....e@e@e.@@..e..e@e..e@ee..
w.ee....e....e.e@@ee@e@..@.e..e@e@.w
..@@e@.e@...@e.e@e.....e.ee@ee.ee@..
..e..e.e....e...@e....e@e@@e@@.@@e..
w.....e@.......ee@.e@.e@e.e..e.e.e.w
..e@.e@........@ee..e.e@e..e@eee@@..
...e..e@....e@e@.@....@ee@.ee@@eee..
w......e.e.e@@ee.e@.ee@.eee@e@@e@..w
..e@ee@..@.@ee.ee@e.@@e@@e.eeee..e..
....@ee..e...@e@@@e@e@.e..e@@e.e@@..
w.e..........e..eee@eee@@e@e@...ee.w
..@e.e...........e@..@e.e@..e.......
....e@.e@ee.ee....@ee@e.....e@......
w.e..e@e..@e@@e...e@@@eee@e@ee.e@..w
..@.......eee@@e@e@.eee@@e..@e..e...
..e.e.....e@@ee.........e@.@ee..e@..
w.ee@eee@ee@e.@.ee...ee@@e.ee@@e.e.w
..@@e.@@e@...@ee@@..e@.e@@.e..e.e@..
..e@e.e@e....ee@ee...e@eee@@e.e.@...
w..@e..e.ee@e.@@e....@e.e@e.@e@.e..w
..ee..e@e@@.e@ee...@e..e@.ee@e......
..@ee.e@e.eee@.@e@ee.ee...@@e@......
w..@@@e@eee@.eee@.e@e@@e@.e..@e....w
...eee...@@e@e@...@e...ee..@ee...e..
.........e...@e...e....@ee.e@e..e@..
w.e......e.......e@ee@e.e@...@e.e@.w
..@e@e..e@.e@e...@e..e@..........e..