33,36
356
356
1000
..e@e@e@e@@e.e@e.e@ee@@e..@e....e@..
w..eeee@.ee..@e..@e@.ee...e@..@e.e.w
....@..e@ee.e@e@.e....e@.e@.e@e.e@..
....ee..e@@e.@ee@.....ee.@e.....ee..
w...e@..@e@e.e@@e...e@@e.......e@@.w
..e@@....e@ee.e@..e@.e.@e......@@e..
...eee...@@e@.@e...e@...e@e....eee..
w....@e.eee@........e...@@e.....e@.w
.....e@e@@e....ee......@ee.e....@e..
..e@e@e@@e@...e@@e@....e.@e@e...e...
w.......e.e..e@@e.e......ee@@e@e@..w
..e....e@ee..eee...e.e@e@..e..@eee..
..@e....e@@ee@@@...@....e.....ee@@..
w.@ee@e....@e@eee..e....e.....ee.e.w
..e@.....eee@..e@..@e@e@@ee@e@@@e@..
..e..e@ee@@@e.....e@ee@e.e@@eee@e...
w.@ee@..e.ee@......e@@e....e@e@@e..w
..e.@@e.@e@.@e.....@.e.e.......e@...
..@eee....e@e..e...e.@.@e.@e....e...
w.e@e@.e@ee@e..@...e.ee@..e...e@@..w
..e..e@e@e@....e@e.@...e@e@....ee@..
..@...ee@..e@ee@...e@..e@e@e@.e..e..
w.e..@e.ee@e@...e...e..@@ee.e.@..e.w
..@e.ee@ee@eee@e@...@e.ee.....e..@..
..............@e@ee@ee.@e@ee..e..e..
w.e@e.....eee@e...e@.@e.e.e@.e@ee..w
..@.e@e..e@@e......ee@e@@.e...e@@e..
..eee@.ee@e.@e.e..e..e@ee@@...@e....
w.e@eee@@@e@..e@ee@@e@@e.ee..e@e...w
..e@@...ee.e..ee@@@e..e..ee..@e@....
..@ee.e.....e@@eeee@..@.e@@e.e.e@e..
w.e@@e@.e@e..ee@@.....e..e.....e@e.w
....ee@e@.....@ee.......e@e@e..e@e..