33,36
362
362
1000
..e@e....@e..ee@......e.e..ee@e.e@..
w...@e...e.e.@ee....e.@.@e.@e@e@@e.w
..........e@eeee@e.e@@ee.@.e@..ee...
...e.@ee.e@.e@@@e.e@@e@@eee..e@@@...
w.e@.ee@e@@ee@e.....e..e.e@..@eee..w
......e@e.ee.e@..e....e@.e@@ee...e..
......e@...@e@..e@@e....e.eee@...@..
w..e@..ee.....e..@e.....@ee.@e@@ee.w
..e.ee@.@e.e@e@e@e.e...e.e@e..ee@e..
..@...e......e@@e.e@...@.@e@...e@@..
w.e.e@@.e@.@e.e....@ee.e.@e..ee.ee.w
.....ee@ee@ee@@....ee@...ee..@@eee..
.....ee@@.e@.ee.e@e@e...ee@..ee@@@..
w..@e@.ee.e@ee@.....@e.e@@@e@e@.ee.w
...e.e@e@.@e...e@@ee@....ee..@e.....
..e@.....e@@e@e.ee@@e..e@..e@@e.....
w..ee@....ee@@ee@@ee@...e...ee..e@.w
..e@.ee@...@ee.e@...e....e@e@....e..
..@e@.@e@..@e@..e...@e...@e...e@e...
w.@ee.e.ee.ee.e@@e.e.e...e@e@e@....w
..e.e@..@@e@@e.e@e.@.@e...e.e@......
..e..e@ee...e@.@...ee@@e@e@e@.eee...
w.@e..@ee..e@e.e@.e..ee.e@....@@@e.w
..@e..e.@e...@..e.@e..e.e....@ee@e..
..e..eee@@e..e..@e@e.e@.@e@..e......
w...e@@ee@@..e.e@.e@.e@e.@e........w
....e@e..ee.e@@eee@@ee.ee...........
.....@e.ee..@@e.@@eee@e@@e..e.......
w....ee.@@e.ee.@e@@....e@e@e@..e.e.w
..e@ee@ee.@e.e.e.ee@e.e@@ee.@ee@.@..
......e@.....@ee..@e..e@ee..e....e..
w...ee@@ee@....@.e@e..e@@@e.@...e..w
....@e.e..e....e...@e..ee...e..e@e..