33,36
361
361
1000
.........e@e@.e@..e@..@e..@e...e@...
w.@e......e.e.@e..@e..e..ee..e.@e..w
..e.e@e....e.....e@e.e@@e@...@e.@...
......ee@@e@@e@..e..@e.e@.......e...
w..e@.@eee..e.e..@eeee@e.@e...e@e..w
...@ee@e@.......e@e@..e..e@@e.e@e...
...e.ee@e@...e@e.ee@e.@e@e@e...e@e..
w.e@.@e@ee.e.@e..e@.....e@eee@..e@.w
..e..e.@ee@@e.e@e@.e@..e@e@@ee...e..
..@ee..e..e@..@e@@e@e@e@.e@e.@e.e@..
w.e.@.....@e.e.e.ee...e@ee@e..e....w
..@.eee.e...e@e@e@@e@e.e@e@@..@ee@..
..e@e@@.@e..e.@e.e.e@ee@e.ee@ee@@e..
w..ee@e.....@.e..@e.e@.e@ee@@e@.e..w
..e.....e...e.@ee@e.@e@@.e@ee@e.@e..
..@....e@.......e@ee..ee.@e.e@@ee@..
w.ee..ee...@e@e.e@@@e.e..e@..e..e@.w
..@@ee@@e..e@....ee.e.@ee@...@..@e..
..e....e@..@ee@e...e@...@e@e.e.e....
w..ee..@e@e@............e..@e.e@.e.w
..e@@ee@.eeee@ee..e@e@e@e@ee@@e@e@..
..e@e@.e.e@..e@@...e@..ee@e..e.e....
w..ee@.ee..e.e@e....e@e@..e.e.e@@e.w
...@.ee@@e.@e.e@.e...e...e@.@e@.e@..
...e@e@e@e.e@.e@.@e..e@e.@e@e..e....
w....@..@e....@ee..e.....@e.e..@e..w
...@ee..e..e@e..@.e@...@ee.e@.e@@...
...e.e@ee@..@ee.e......e.@..e@eeee..
w.....e@.e@.ee@...e....@.e@e....e@.w
......e...e..e@ee.@ee@ee............
..@e.e@.e@e..@e@@..@.@e...e@e.......
w.e@.e@.@e..e@..eeee.ee......e@e.e.w
......e......e..e@@e.e@e@e...@e.e@..