33,36
358
358
1000
.......e.e@e...e..e@ee....e@@e......
w..e..e@.e@e...@e..e@@.....ee...e..w
...@e.e@@e..e@e@...@ee.....e@@e@@...
...@e..ee...@e.e.eee@e@..e@..e@ee...
w..e@..@....@e.e@@@..eee@.e..@e....w
...e@e.e.e.ee..@eee..@e.e.@..eeee@..
..e@e...e@e@@ee@.......e@.e.e@@@ee..
w.e@@e@e@.e@e..e.e@e...e@e@.@ee....w
...e@e@ee@..@...ee....e@@e.e..@.@e..
....e@.@ee@ee.ee@@.e..@.eee@@ee@e...
w....e.e@e@.@.@.@e.@..ee.@e.e@.....w
...@e@.@e@e.eee@e..e..e@ee@.........
...ee@.@e...e@@...e@ee@e.........e..
w..e.e@e....e@e...e.@@e@.e@e.....@.w
...@ee@@..@e.@e..e@@ee....e@..ee@e..
...e@.eee@e..ee..e@e....@e...e@@e...
w.e@e...e@e@ee@...e@.e@ee.....e@@e.w
..e@@e..e.........e@e@..@e....@e@e..
..eee..e@e@....e..@e..e@e....e......
w.@@@..@e@e....@ee@e@........@ee@e.w
..eee.e@e.@e.e....@ee......e..ee@@..
..e@ee.@ee...@ee@ee@...e@e.@e.@.ee..
w...@@ee.@e@e...e.@e...@@ee.@ee@...w
..e.e..e@ee@e@e@@e@...@ee.@e..@e....
..@e...e@e@e..eee@e...e....@..@e....
w.e@....e..@e.@@e@e..e@..eee..ee...w
...e....@e@ee@ee.....@e@e@@@e..@@e..
..e@..ee..e@...e@e@e.e.e@.eee..ee...
w.@e.e@@e@e@e...ee@e...@eee@@e.e...w
..@ee@e@eee@e....e@e@e.e@@.....@e...
..e.@@e@..e@e....@ee@e.e.ee...e.@e..
w.e@ee.e......ee...e@e.@e@@ee.@e...w
..e@e.e@.....e@@e....e@e....@e......