33,36
347
347
1000
........e@e..e.....ee.e@ee@...@e.e..
w.ee...e@e.e.@.ee@.@@e...ee.e@ee@@.w
..@@e..e@@e@.ee@ee@e@...e@..@...ee..
..e@ee..ee@e@eee@@e.ee...@eee...e@..
w..e@@e@@.@e@e@e.@e@e@@e.e@@e...@e.w
....e@.eeee.@ee@.ee@e.e@..e@ee@e....
.....e..@@e@e@@e.e...ee@e..@eee@....
w..e@e@.e.@ee@e..@e..@e@@e@ee@e@ee.w
....eee.....e@e..e@e@e.eee@.e@@..@..
...e@@ee@ee....@e..@e@..@@e.eee.ee..
w..@e@.e@@@e...e........e.@e@e.e@..w
.....e@.ee........e@e.e@e.eee@.e@e..
...e@@e@e.@e.eee@.@.e.....e@@..e@...
w...e@e...e@.@@@e.ee@.ee..e@e...e..w
...e@....e...ee.......@@.e@.@..e....
...e@e..e@.......e@@e.ee..@ee@e@....
w...e@e@e@...eee..ee@...e@e@.ee@e..w
...e@@ee.e..e@@@e...e.e.e@e..@e..e..
...e@e..e@....e@e...@e@e@ee@e@@e.@..
w.e@.e@e@......@e@e.e@...@@e@e@e.e.w
..@.@e@e@e.....e...@e...ee.e...ee@..
..e.e.ee...e@e.....e.e@.@@e@..e@.e..
w.@e..e@....e@e.e@e...e.e........@.w
...@..e@e...e@@e.e@e@e...........e..
...e..e@@e@..e...@...@ee@e...e......
w...ee.e.@e......e..e@e@e...e@.e...w
....@@e.e@ee@@e......e@@e@e....@....
..e@ee@@e@..ee@..e.e.e@ee@@e@..e@...
w....@.e@e......e@e@.....e@.ee.@e..w
....ee..e....e@e.e@......@ee.@.@e...
..e@@...@....@...@e@..e..ee@.e@e....
w.@eee@.e@e..e.ee..e.e@.e@.@e......w
..e...e..e@...e@@e.........e@.......