33,36
351
351
1000
..e@e@...e.e@e.e...e.....e@e.e..@e..
w..e.e.ee@@e...@e..@e.e...e@.@e.e..w
......e@@eee.e@e@.e@ee@....@e@e@@...
...e@ee..e@@ee@e..@e.@ee@..e.e@ee@..
w.@e.e@...e@e@......e...e.....@eee.w
..e.......e@e..e@ee@@e.e......e@@...
..@e....ee@.....e@.e@e.@e.e@....e...
w.e@....@e.....ee.ee@@eee.@e.e.....w
...@e@e.e@....e@@.@ee.e@@...e@e@e...
...e....@e@e..@@e...@e.@e...e@@e@...
w.....@e@e@e@eee.......ee@..ee@ee..w
......e@..e@e@.e@e.e@....e.e@@e@@...
...@e...ee@.....e@.ee@e@e@.e@e..e...
w..e.e@e@..e@@e@..e@..e@...e@e...e.w
..e@e@.@e.e@ee.e..@..e@e.e@e.e@.e@..
...e@e....@.@..e..e..@e@e@e@.@e.@...
w...e@.e@eeee..@e@..e@.@ee...@e.e..w
..e@e..@eee@.ee@ee.e.e.ee@e@ee@.....
..e@ee.e@@.ee@..@..@e@..e..@e@.e....
w.@@e@@e.e@@@e@ee..e@..e@..ee.e@...w
..ee..e@..eee.e......e@e....@e@..e..
.....ee@e.....@ee.e...e....@e@@ee@..
w.e@e@@e.....e@e@e@...@ee..e..e@e@.w
..eeee@@ee...e@e@e...e@@@e......@e..
..@@@ee.e@.ee@....@ee.ee@..e...e....
w.ee...e@..@e.....e.@e.@e..@e.e@.e.w
..e@.....@e...e@e.....e@e.....@e@@..
.....e@@ee..e@ee@.e...@.@e@e..e.ee..
w.....eeee@..e@@ee@e@ee.e......e@..w
.....e@e@.e...@e...e@e.e@e.e..ee@...
..e@e@e...@e..e@....@e.e@@e@..@@e...
w..@e.@e.e@e.....e.ee.e.ee....e....w
...e@e@ee@......e@e@.e@.@e...e@.....