33,36
352
352
1000
...e@@ee@e@e.....@e....@ee@e@e......
w...ee...e@e.....e.....eeee.e@@e...w
.....e@.e.e@........@e@@@@....e.....
......e.@e..........e.eeee.@e.......
w....@eee@.....e.@e.e.@...ee@e.....w
.....e.@@e.....@.eee@.e@e.@@.e@e....
..@e@e.eee..ee.e.e@@ee@...ee....e...
w.ee..ee@@.e@@e.e..@e...e@e...e.@..w
...@e.@e@e..e@..@e.e@e@e.@e...@.e...
..e@@e@@....@ee@e@.e@e...e...@e.e...
w.eee@ee.....e@ee@e.e@e@e...@e.e@e.w
..@e@...ee.e@@ee@e@e@......ee....@..
...@ee.e@@e@e@.e...@e.....e@@e.e@e..
w....@ee@e@..e.@e.e@....e@..e..@e..w
....e@e@ee@e..e@e..ee.e@ee..@eee@...
..e@@ee.......e@...e@e@e@.....@@e...
w.@ee@@.e@e.e@.e.@e@e@.e@e..e@e@...w
....@.eee@@e@ee@.e..e@....e@@e.e....
..e.e.e@@e...ee@..e.@e@e...ee..@....
w.@ee..e@ee..@ee..@....e...e@..e...w
..@e@...e@@e...@eeee.e@@e.@e@e......
..e.@ee@..e@e@e..@e@.eee@.e@.@......
w...ee.e..@@e@ee.ee@e@....e@.e.....w
.....@e...ee...@e...e..e...e@@e@e...
..e@e@....@.ee.....e@ee@...@e...@e..
w.@e.e...ee.@@e...e@@ee@e....e.....w
...@e...e@e@e@@e@e@@eee@e...e@eee...
.....@e.@e@e.e..e..e@@e..e@e.e@@@e..
w.@e@e@ee.e@.@e....ee@@e@e..@e@e@..w
..e..e@@..@...ee.ee@@eee@e@eee..e...
..@ee.ee.@e...@@e@.....ee@e.@@e.....
w.@e@..@@ee@..e@ee@...e@@e@.e.e....w
..e....ee..e......e.....ee@e@e@e@e..