33,36
359
359
1000
..@ee..ee@e.e.e@.....e@@eee@e.@ee@..
w.ee@@e@..@e@.@ee...e.eee@@@e.e..e.w
..e@.e.......@e@@eee@@e.eeee@.e@e...
..@e.e@e@eee.e..e@@@ee@e@@...e@.....
w..@e..e@e@@e.e...e@e....e.e..ee@e.w
.....e@e@e.e@.@e.@e.@e....e@ee@.....
.....ee@.@e..e...e@e.@ee@e@e@e.e@e..
w....@.....e.@e..e@@e@e.@e@ee@.....w
.....eee@.e@..e...e@e@eeee@ee@e@.e..
..e.e@@ee.e@..@........@e@@e@e@ee@..
w.@ee@@ee.@ee@e.e@e.ee...ee..e@e@..w
..@e.eee@...@ee..e@e@@e.e@e.@e......
..e........e@e@e@e.e@@e@e@@ee.......
w..e@e..e@ee.ee@.@..ee.e@e.@e..e@e.w
..e@e@...@e@e@e@ee.e............@e..
..@e.@e..ee@e@@@e@e@.....e@.....e...
w.e.@ee@.....eeee@@e...e.@e........w
..@.ee.e........ee.e...@e....ee@....
..e.e@.......e.e@@.@e@e.....e@@e....
w.e@@e..e....@...ee@@@e.ee.........w
...e@e.e@..e.e....@eee.e@@e@e@e.....
..@e@eee@@e@..........e@e@ee@e..@e..
w.e..e@.ee...e.........@e@.ee@e.e@.w
..@.......e.e@..eee.e@ee.e.@.e@@ee..
..e..e@e@e@....e@@@ee@.....e.@ee@@..
w....@e.e@.@ee@e@e...e@eee.e@....e.w
...e@...e@ee.e@ee..e...e@@e@ee@ee@..
..e@e....e@..@@e@e@@ee..@e.e@...e@..
w.@e@....@e@eee...e..@..e........e.w
..@e...e@e.......e@.@e......e@e.....
..e.............e@..ee....@e...e....
w.@.ee........@e...e.@@e.@ee@e@@ee.w
..ee@@e.......e@..e@.eee@ee@e.e@e@..