33,36
352
352
1000
..e@e@e.....ee@e.ee..e.@e@..e@e.....
w.e..eeee.ee@e@@e@@e.@ee.e.e..e.e@.w
..@ee@@@@e@@e@e.e@ee@..@e..@..@.@e..
..e@@eee@e.e....e@e.e...@e@ee.e@....
w.....e.e@.....ee@e.@ee@e...@e@e...w
.....e@e@e...ee@@ee....e@..e@e..@e..
.....@e..@e@.@...@@e........e@..e...
w.....@e@e.e.ee@ee........@e.......w
......e@..@e@....e@ee@e...e..e.e....
.......e..e.e..e..e...e@e...e@.@ee..
w....e@@e.e.@e@@e@@ee@e.....e@..e@.w
..e...e@ee@ee.e@.e.@@e.......ee@ee..
..@e....e@..e..ee@.e@e@e@.e.e@@.e@..
w.@e..e@e@.e@.e@@....@e@ee@..@e..e.w
..e@e@.e@ee@e@e.e.e....eee..@e..e@..
....@e...e......@e@@e.e@@@e.eee.....
w..e....e@@e@e....@e@.eee.@ee@@....w
..e@.....@e..@..@ee..e@@..ee@.e@e...
..eee@e..e.@ee..e...ee@e@e@.e.......
w.@@e@e....e..eee.e@@@@ee@..@e@....w
..e@....@ee@@e@@@e.eeee@.e@e..e@e...
...e@e@ee.@@e..ee@.....@e....@e.....
w...ee@e..eee..e@@e....e.@e..e.e...w
......ee....@..e@e.......e@..e@@e...
..e@ee@@e..ee..@@e.@e.....e@..e@e...
w.@e@e@ee@e@@e@ee..e...e@e.e@...e@.w
..e..e@@@e..@e.........e@e@ee....e..
..@..@ee@.@eeeee.e@...@e@.e@.ee.....
w.e.....e.e@e@@@.@eee.eee@e..@@e@e.w
.......e@e....ee...@@ee@.@e@.e@e....
.......@e@....@e..@e@...ee@ee@...e..
w.@eee...@ee@ee@..eee.e@@....@e..@.w
..ee@@e..e.......e@@e@eee....e...e..