33,36
351
351
1000
.....e.@ee@e....ee..e@e....e.e.e.e..
w.e.e@@e.@e.e@ee@@e.e@e@e..@e@.@.@.w
..@ee@ee@.e@@e....@..@e@e.eee@ee.e..
....@ee.e.ee......e..e.e@e@@ee@..@..
w.e@e@@...@@e...e@.....e@e.e@e...e.w
..e.e@e...e.@....e...@e@e@...@e.....
..@ee@ee....e.@ee....e.@e....e@e....
w.@e..e@@e@ee.e@@e@ee..e....e@@e.e.w
..e.eee@e@.@@e....ee@.ee@e...@eee@..
..@.@@e@e..e.@....@e.e@..@@e.e.@e...
w.eeee@ee....e...e....e..ee@.@e@e..w
..e@@ee@@eee..e..@e...@e@@e@e.@@e...
...e@ee@e@@@ee@e@.....e@e...eeee@...
w..@e@e@eee...@ee....e@..e@e@@@.@e.w
...e.e@@e@.e.ee@@e@..e.ee@e@.ee.e...
....e@.ee@e@e@e...e..@e@@ee@e.ee@e..
w.@ee@.@@e@...@@eee..e..e.e@@.@..@.w
..e..e@e.ee@..ee.@@ee@.e@@eee.e..e..
.......@e@.ee....e@e@@e@.e@...e.....
w........@ee@e@ee..e.e.e....ee@e@e.w
..e......ee@@ee@@..@e.e@...e@@.@....
..@.e.e.....e@@ee..e@e.@e..e@e.e@e..
w.e.@e@.........@ee@e@.e..e@...@@e.w
...eee@.........e@.....@ee@....ee...
..e@@.e@..............e@..ee.e..e@..
w.@@e..e..e@e......e@e.eee@@e@...e.w
..ee.......@e@@e.......@@e......e@..
.......e...e.ee.......@e......e@ee..
w....e@@e..@e@.....e..e...e....ee@.w
..@e@ee@...@ee@ee.e@e.@...@eee@@e@..
..e@@e.e...e..@e@.@..@eee.e@@eee.e..
w...e@.@e.....e...e..ee@@ee@e..@...w
.......e@..e@e@......@ee@e.....e....