33,36
364
364
1000
..@ee@e@e.e@e@.e..eee@ee.@ee.e@e@...
w.eee@eee@e@eee@ee@@ee@@eee@..e.ee.w
...@e@e@.e@@e.e.@e@e..e@.@e......@..
......@...ee..@ee@e@..@e......e@ee..
w.....e...@....@@e.....e@e.@e.e.e..w
...@e....ee@e..e...e@ee@..ee@e@e@...
..ee.e.ee@@e....e@e@e.e@ee@e@@.@@e..
w.@@.@e@e@e.ee@e...e@....e@eee@ee..w
..ee..@.....@e.e...e..e@e...e@ee....
..e@.eee@e...@e@.e@@.e.e..e@@e@@e...
w....@e@......@...ee.@.@e.@e..e@ee.w
.....e...@e...e...@..e.e....ee@ee@..
..@e.e..ee@....e.ee.e@.@e@e.@e@@e@..
w.e@.@ee@....e.@e@..e@.e@.@ee.e..e.w
..e@@e@.....e@...e@e.e..e.....ee....
...ee....@e.@@ee@@e..@.e@.e..e@@e...
w..e@e...e.eee.@ee@..e..e.@.....e..w
....e@..e..@e@..........@ee...e.@e..
..@e.e..@e.e@@e..@e..e...e@...@ee@..
w.e..@.e@@e..e.e.e..e@..e@.ee@ee...w
...e.e.@e@@e.@e@e@...e....e@@e@@e...
...@e.e..e@@e.ee@....@.e@.@@e.e@.e..
w.....@ee@e@.e@......e..e.ee..@e@@.w
....e..e@..e......ee..eee@.e.e@eee..
..e@@ee@@e.@.e@e..@@.e@@eee@e@@e....
w.@e....e..e.e@@e.ee@....e@e@.e.e@.w
..@e..ee..e...e...@@ee...e@e.e@e.e..
..ee.e@@..@.......ee.@e.e..@.@e..e..
w..@eeee..e.e.ee.e@@e..e@..e.....@.w
..e@.@@...ee@e@@ee@@ee.e@e.ee.e@ee..
..@e.ee..e@@ee@e.eeee@....e@@.@e....
w.e..e@.e@e@e@.e@@@@@@e.....e......w
..@ee@.....e@...eeeeee..............