33,36
358
358
1000
....ee.e@@e.e..e.....e@....e.ee@e...
w..e@@..ee.e@ee@....@ee...e@e@.@e..w
..e@@e.eeeee@@......e@@e....@eee....
..e@e..@@@@eee......@.......e@@.....
w.@eee.eee.e@e@..ee.ee@e......e..e.w
..e@@@.@e@.@e@e..@@.......e.....e@..
..e@ee.ee@eee@@..ee...e..e@.....e...
w...e@..e@e.@ee..@e@ee@e@e@e...e@e.w
....@...@e@.e@..e@@e@@e@.e@e..e@e@..
....e...ee@ee@e@@e...ee@@ee...@e....
w.e.@@e..e@e.e@ee@....eee@@e.e@e.e.w
..@eeee...@e.@e...e.@e@@ee@e....e@..
..e...@.e.e@e@e@ee@@ee..@e@@e@e..e..
w.@...ee@e.....@e@@ee@e@e.e@@@e..@.w
..e.e..e.@....ee..e@.......eeee..e..
..@.@ee@.e..e@@@e............@@e@...
w.e.e@.@e...@ee..@e.....e.e@eee.ee.w
..@e..@ee.....@e.e@ee...@eee@@..e@..
....e@ee@e........e@@e@e@@@.ee..e@..
w.ee..ee@@e...eee@@e@.e.eeee@...ee.w
..@@e@@@e....e@@ee@.e..@e.@@e@e@@e..
..e..ee....e@e.e@@e@e@.e@.e....e....
w.e.e.....e.....e..e.ee...@..ee....w
..@e@.....@@ee.e@..@e.@ee.e.e@@@e...
..ee@.....eee@e@.e....e@@e@e@@eee...
w.@ee.....e@..@@e@....e@@e...e@.@..w
..e@.....e@...ee...e.e.eee@e.@..ee..
..e..e@....e...e@ee@e@ee.@e..e.e@@..
w.@e..ee@..@@e.e@e@e.e@@e@ee.....e.w
........e.@ee..e@..@ee@e...@e.......
..@e.e@...e.....e..@ee@.....@e@e@...
w.e...e..e@ee.....@e..ee@e.@ee@@e..w
..e@e...e@e.@e....e....e@e.e..e.....