33,36
367
367
1000
.....@e...e........e@.e@e........e..
w..e@e@..e@e........e.e@..ee@e..e@.w
......e@e..@.eee....e@.e.e@@@e.@e...
..e@e.@@e..ee@@@e..@ee..e@@eee@e....
w.@.e.ee..e@@ee@e..e...ee@e.....e@.w
..ee@..@e..@e......@e.e@e@e...e@ee..
...@...e@@ee.e@e......@e..e@e..e@e..
w..e.....e@e...@@e..........e@..e@.w
..e@e@ee@e.@.e@ee...ee@e..e.@e..@e..
..e@@@e@e@.e.e@@e...@e..@e@e@...e...
w..eeee@e@ee@.e.e.e..@..e.e@e..e@..w
....@e.ee@@@ee@e@e@..e...e@e@e...e..
..@ee@..@ee@e@@e......e@e@ee.@e.e@..
w.e.e@e@@eee..e@...e.e@eee@@e@@e...w
..e@eeeeee@......e.@..e@@e@@ee@@@e..
..@@e@@e.e@e.e@e.@.e@ee@@eee@.eee...
w.ee.@e..e@e..e.ee....@ee...e..@@e.w
.....e...@.@e@@e@e@....e...e@.ee@...
.........e.e.e@@@ee....@@e.@e.@ee...
w...ee..e@e...eeeee..e@ee.e@@......w
....@@ee@.ee@...e@@e@@ee.e@ee.@e.e..
...@e@ee@e@.e.e@e@e.e.e@.@ee.@eee@..
w..e..e@.e.ee.@e...e@..e@@e@.e.@e..w
..@ee.@ee@e@@e..........eee...e..e..
..e.@e.e@@ee@..@e........@@e.e@@e@..
w.@@e..@ee..e..e...e@e.eeee...@e@..w
..eee..e....e@....ee@e@@@@@e..e.e...
....@e.@.....e@e.e@@e.eeee@.e@e.@...
w..e@e.e..e..@e.e@......@ee.e@..e..w
...@e.ee..@ee@ee.@ee.......e.e@.@...
..@e..@@.e@e..e@.e.@e......@.ee@e...
w.e..eeee....ee....e.......ee@.....w
....e@.e@...e@@e...@e@ee@e..e@e.....