33,36
358
358
1000
..e.....e@@e......ee@e..e...@e......
w.@.ee@e@ee...@e..@ee@..@e..e@e@e..w
..ee@@.e...e..e..e@e...e@@.e.ee@e...
..@e@ee@e.e@....e.e@.e.eeee@.e@@ee..
w.@e@.@.@.@e....@....@.@....@e@ee@.w
..eee.e.ee@@ee@ee....e@e..eee.e.....
...@@....@e@....e...eee@.e@@e.@e....
w..ee...e@eee...@e.e@@..e@ee@e@@e..w
..........e@@e.e@..e@e..e@@e..e@....
..@ee.....@e.ee.e..e@e@e.e.@e@ee....
w.e.@e@e.....@@ee..@e@......e@e@...w
...ee@@e.e@e.e@@@e.e.@e...e.e@e@e@..
..e@@@ee@ee@@eeeee.e.e@...@e@@e..e..
w..eee@..@e@e@@e@@e@e@e...e..e.....w
..e@e.@e......@ee@ee@.@e@e@.e..ee@..
..@@e.e..e@e.ee@@e.@e..@ee@e@..@@e..
w.ee.....e...@@e.@...e@.e.e@.eee...w
..@e..e.e@.e@ee@.e....e.@e...@@.....
..e@.e@e@@e............e@e...ee@e...
w.e@ee@e.e..e@e..e......e@...@.....w
...e@.@e....e@e..@e@e.e.@e.e@e.e@...
......ee@e@e@@e@e.....@e@@@e@e@eee..
w....e@@e..e.ee@.e.@e.e.eee.e...e@.w
..e@...e@.e@...ee@@e.e@..e.e@....e..
...ee@e..ee......@e....e@@e@....e@..
w.e....ee@@...e..ee...e.e@@..@e..e.w
..@....@e.e...@...@e@e@@eee..e..e@..
..e..e@e@e....e.....ee@e.e@.........
w..e...e.@e@ee.......e@..e@ee@e@ee.w
..e@..e@e@e.@@e.......e.ee@e@e...@..
..@e@ee.....e@e@e@.e@..e@.@e.....e..
w....e@....ee@e..e@ee..ee.e....e.e.w
..e@e.e@e.e@....e@e...e@@ee@e@e@e@..