33,36
352
352
1000
..e@@eee@..@ee@.....@e......e@e@....
w..ee@@ee@ee..ee...@e..ee@...@ee...w
...@....e@e....@...e.ee@.e...e.@....
...ee@...@e....e....e@.@e......e....
w.e@eeee.e....@e@e@e@..e@e..e@e@e@.w
..@e@e@@ee@e..e...e@@eeee@e@e....e..
..ee@@e.@e@@e.....@ee.@@.@ee@....e..
w.@ee@e.e@ee@.e..ee...ee.e@@e....@.w
..e...@e@..@ee@.e@@...@.@e.@e@e..e..
..@........e@@e...e...e.e..e........
w.e.....@e.@......e@...e......e....w
..e@e.e.e.eee@e.e.@ee.e@....e@@e@...
.....e@...@e@e@.@ee@@......eeee.e...
w.e@e...e.ee.e@e....e.eee..@@e..@e.w
........@..@.e@e...e@.@@@e.e@e@e@@..
........e..eee@e...e@eee.e.e@e@eee..
w..e@e.e@..e@@ee.....e@@.@..ee@@e..w
...e@......e@@e@e..e@@ee@e@ee.ee.e..
..@ee....e@.ee.e@..@e@e...e@@e@@e@..
w.e......@e.@e.e@e..e@e.....e.ee@..w
..@e..e@e@e..e.e@e...@e.....@e@.....
.......e@e@..@e@.....e.e@e..e@..e...
w......@....e@@@e...e..@e......e@..w
..e.e@.e@e.eeeee....@e@e@..e...e@e..
..@e@ee@@e.@@e...ee@ee@.e..@e.......
w.@e.ee@e@.e@...e@e@e.ee@e...e@ee..w
..ee@@@.e@.@e@.....e@.e@@e@..e..@e..
....eee@eee@eee@ee.@e.@ee@eee@...e..
w..e@.@e@e@@e.@e@@e.e@e@..e@..e.e@.w
...e@.e....e....@e@.e@e.@ee..e@.e@..
....ee@e@e....e@e.@e..@ee@@e@e@e.e..
w...e@@ee@@e.ee@@.e.....e...ee@ee@.w
....@ee...e..@eee.......@e....e@....