33,36
372
372
1000
..e@@ee@@e.e.e@e.....e@e@e..e@......
w..ee..ee@e@...e.@e@.e@.@e@e.e..e..w
........e@.....@ee.ee.eeee@.@e..@e..
....e@e..e..........@ee@..e@e.@e@e..
w.e..@e..@eeee..e@e@ee@e@@e...e.e@.w
..@..e@..e.@@@ee@@e.@e@eeeee@.e..e..
..ee..e@.@.ee..e@e..e.e..@@ee@@ee@..
w.e@..ee@e.....@e..e.e@..e.@.e@e@..w
..e...@e@.e..e.e..e@..ee@e@eee@.....
..@.@ee.e.@.e@.@e.@e..@ee..e@@e@e...
w.e.ee@..@e.e@.......e@e@.e@@e...e.w
.....e@e.e@.@e....@e......e@ee@ee@..
.....e@e@ee..@.e@.ee...e.e.....e....
w....e@e@e@..e..e..@...@.@....e@e..w
...e@.@eee@e....@e.ee@.e.e....ee@...
....e@e@@e@....e@e@e@e.ee.....@@@e..
w.e.ee..e.e@e...ee@e...@@...e.eee..w
..@e@@e..e..@..@e...e@eee..e@e@@ee..
..@ee@@.e@..e..e..@e@e@@@.e@e@.e@@..
w.e@.ee@.....@e...e....eee.....e@e.w
......ee.....e@....e@e..e@....@e@e..
..e@.e@.@e.e@e...e@e@...@ee@.@e.....
w..e.@e.e.e@....@e..e.e...ee@e.e@e.w
...e@@e@..@e@...e...ee@e..@e...eee..
..@eee.e..e.e.@ee.e@@..@e@ee..e@@@..
w.e....e@e.ee.ee@..ee...e@e@@e.@ee.w
......e@e@e@@e@@e....e.eee@.e..e....
..@e.e....e@e@e@e@ee.@e@@e....e.....
w.e.e@@ee@eee@e@e.e@.ee@@e..@e@....w
......ee@e@@e@e.......@ee...e..e@...
...ee.e@@e.@e@eee....ee...e@@@e.ee..
w.e@@e.eee.e@.e@@ee..@@e...eee...@.w
...e@ee@e@e@..e@ee@..e........e@ee..