33,36
361
361
1000
.....e@.e@...@ee@.e@e.e..@e@e..e.e..
w..e@.e..e.e.e.@e.ee@.@e@e...ee@e@.w
...ee.@e@e@@.e@.ee@@e@ee..@e.@e..e..
..e@.e@e@eee..e.@e@e..e@e.e.e@e..@..
w.@@e..e..e@.e.e......@@eee...@..e.w
..ee..e@.e@e@@e@....e@eee@@e..eeee..
......@ee@@ee@ee....e@e....eee@@@@..
w.....@ee@eee@@@e..e@e@e.@e@@.@eee.w
......e@e@.@.ee@.ee@ee.@.e.@e.ee@@..
........@e.e..@e.@@e.@.e.@ee..@e.e..
w.e@..e@e@.....@ee@e@e.@...e.e@@.@.w
...e@ee@e..e...e@..@@e@e@ee@e.ee.e..
....@ee@ee.@ee@@@e.ee.@e.@e@@e@.e@..
w...e...e@..e@eee@..@.eee@ee.......w
...@ee@..e.e@..e@e..ee@@e@eee.@ee...
..ee..ee@@.e@e.@e@......e.e@@ee@@e..
w.@@ee@.ee.e@e.e......e@@...e.e@@e.w
..e@e@..e.e@@e..e@e....eee@.@e.ee@..
...@e...@ee@e....ee@@e....e.@e.@e...
w..e...@e@@.....e@eee.......ee@e@..w
.....@ee..e@e.e@e.@......e.e@@ee....
.....e...e@.e..@e.e..e..e@....e@....
w........e@e@..e..e@e@..@@e@e.@e...w
..e@ee....e@ee@@e......@ee..e.e.....
...e@@.e@@e.@.e........ee.e@@e@e@e..
w..e@e..ee..e.........ee@..e.e@e@e.w
..@e....e......e@..ee.@.ee...@e..e..
..e....e@.e..e..e.e@@ee.@@@e.e@@e@..
w.e.e..@..@.e@...e..e@..eee.e@@e@..w
..@e@@eee@e.e@e.e@.e@.e.....e@e.....
...@eee..e..e@e..@e...@e....e@@.....
w....e@e.@.......e...e@e....eee....w
....e@e..e.e@e.......e@e....@e......