33,36
360
360
1000
..@e.e@@e.......ee@..e@..e@e.ee.....
w.e..@ee@.....e@@ee...e..e@ee@@....w
..@e..........@e.....e@@e@ee@.ee@...
....e.ee@e.....e.....e@ee@@@@e.@e...
w..e@.@e.e@...e@.....@...eeee.e....w
.........@e.e....ee..e...e..e@@e....
..e.e@@e.e..@e@ee@@e..@ee@e@.ee.....
w.@..eee.@ee@.e@@e@e@@e.e..e..@e...w
..e..@e@e@@@e...@ee.ee@e@.....e..e..
..@e.e..eee.....e@...e@@ee.eee@.e@..
w.@e@@e@@.@e@e....e@.eee@@.@@e@....w
..e.e..ee.e@@e@...@ee@@.@e.ee@eee...
..e@ee......e.e....@e.eeee..e@e@@e..
w.e@e@@e..e..e@@e....e@@e@...e@e@e.w
..@e.@e..e@..e@e...eee@ee.......e@..
..e.ee........ee@e.@@@e.@e......e@..
w.@e@.e@e....e@e@@eee@e@.e@@e@e@ee.w
.......e...e@..@e...e@@e.@eee@e.....
..e...e@e@@ee@..e@e..e.....@e@@.....
w.@e..@eeee.@ee@@ee..e@e..e.@ee....w
.......@@ee.@e.e.e@..e@e..@e..@e....
..e....e@e@ee...e@@e.e@e..e.....e...
w.@..e.@...@e...eeee..@e..@e..ee@e.w
..e..@ee@......e@@@@..e....e..@@e...
..e@e@e@e......e.eee..e@e.e@eee@e...
w..e@@e.@e.....@..e@e..e@.@e.@e.@e.w
..e..e.e@eee..ee.e@@e.ee@.e@..e@e@..
..@e.e.e@e@@ee@e...e..@.ee@...@e....
w.e@e@..ee@@e@e......ee..e@...@e...w
......e...ee@.@.e...e@..@ee...ee....
.....e@..e@@@ee.@.ee@@e.e.@...@@e...
w..e@@e@e..eee@ee.@@eee@eee...e@...w
....eee@e...@ee@@ee...e@e@@e...e....