33,36
368
368
1000
......ee@e.........ee@e@...e.....e..
w.e..e@e@e....e@e..@e@ee...@e...e@.w
..@e@e@@@ee...@e.ee.....e@e.e.e.....
..@ee.eee.@eee..e@@e.....@e.@e@.e@..
w.e...e@...e@@e.......e..e..e@@eee.w
...e@.@e.e..e@@...e..e@......@e@@e..
..@eee.ee@..@ee@e.@ee@@e@e..ee.e@e..
w.e@e@e@@e.e@e@@ee@ee@e@e.e.@eee@e.w
...e....e...@e.e@.@e...e@.@ee@@e@e..
..e@...e@@e.e.e.@ee......e@.@....e..
w.e@@eeeee@.ee@@e.....e@..e.e.ee@@.w
..eee.@@@...@e@e..e.e..e.....e@eee..
..@e..eee.e.....ee@e@.e@e.e@ee@@....
w..eee...e@e@.e@@e@e..@@e.@e.eee@..w
...@@@e..@e.e.@e.e@...ee.....@e.e...
...ee.@e..@e@.e@e.e....ee@e..e@ee...
w.e.@e@e...@....@...e@e@......e@@..w
..@e@e.@.eee@..ee.....e@ee.....@ee..
..@e..eee@@ee..@e@e@e.e@e@e@e..e@@..
w.e..e@.e@e....e@e......e@@@ee..ee.w
.....@e.....@e.@e........eee.@.e@@..
......e@e..ee..@ee.@e@ee..e@ee@@.e..
w.....e@e..@@e.e.@ee@..@..@e@.ee...w
..e@e.e@e..e.......e@eee@.@ee...e@..
..e@..@e@e@e.@e....ee.@@e@e.@e@e.e..
w.ee......e..ee@@ee@@.e.e@@e@e...e.w
..@e@.e..e@....ee..@e..e.eee@@e..@..
..@eee@..@e.......ee@..@e@..e@e..e..
w.e..e@...e.....e@@e@e.e....e@e@e@.w
...e..e..e@@e..e.e@ee@.@ee..@e@.@...
...@...e...e..e@..e@...e@@e..e@ee...
w.ee.@e@e@.@e.e@e.ee...e.....e@@.e.w
..@e@e...e...e@..e@@e.e@......eee@..