33,36
365
365
1000
......e..e@e.e@@e.e..e@e@.....e.....
w.@eee@e@e.@e@eee@@ee@e.eee@..@....w
..e.@e..eee.e....e@e@e@ee@.e@ee@....
...e@e.e@@@e@.e@e.e@@e.@.......e....
w.e..@..eee@e.@.ee@@e.ee.ee@ee@e@e.w
..@..e.e@e@e@.e.@.@e@e@..@e@ee@.....
..e.e@e@e@@e@e@.e.e..@eee.e...e.....
w.e@e...e@e.@e.......@e@@e@e.ee....w
..@ee.e@ee@ee...e.e@ee.....@e@@e....
..e@@e@@e@e.@e@e@.e@e@.@e.e@e@@ee...
w...e..e..@.e.e@e@e@e..e..@e.eee@..w
......e@e.e...e@e@...........e@.....
...ee.e@@e...e@..e...ee...e.....e...
w.e@@e.e.e@......@e.e@@e.e@..e@e@e.w
....@eeee.e.......e@e@@e.e@e.@...@..
..e@ee@@@.@ee@e......ee@.e@..e...e..
w..e...ee.e.e..e...e..e@e.e...e@e..w
...@@e@e..@e@e.@eee@e@e@e...e.e@.e..
...eeee....e@@.e@@@e@.eee@ee@@eee@..
w.e.e@@e....ee...e@e..@@e@.e@ee@e..w
..@ee@@e@e@.@....e@@e@e.@e....e.@e..
.....ee.@ee@e.....e@ee.e@e...e@.....
w.....@.e..@ee@e...e@@e@@ee.e@.....w
..e@e@e.e@@e@@e....e@e@.e.@.e@e@e...
...@e....eee..e...e@e.e@..e..eee@e..
w.@e.e.e@e.@ee@@e.@....e@....e@@e@.w
..e@.@....e@@@ee@.e..e..e........e..
.....e..e..eee@.e..ee@.e@.e@e....@..
w.ee....@e..@...@ee@@ee@@ee......e.w
..@@..e@...ee...@e..e..@e.@..@ee.@..
..ee...ee@e@....ee@e@e.e..e..ee@.e..
w.......@....@ee..ee@@@ee@..e......w
........e....ee@....eee..e..@e......