33,36
351
351
1000
..e.@eee............e...e@@e..e.....
w.@.e@@@@ee........e@....ee...@eee.w
..e...eee@@e.......ee.@e.ee..e.e@@..
..@.e..@e..@.ee..@e@@.e..@@ee@..@e..
w.e.@..e@@eee@@e.e@.e..e.e@...e@ee.w
....ee@e.e@e@e@@e.e...e@..e...@e.@..
.....e...@e...e@..e..e@e..@..@e..e..
w.@e.@e.e@.e...e..@ee@e..@e..e@e@..w
..e@e@.e.e@@e......e@e@.@ee....ee...
.....e.@e.e@e@e@.@e@..e.e@@e@ee@e@..
w...e.e@.....e.e@e....@e@.ee@..e@e.w
...e@..ee....e@.e@.....e@e..ee.@ee..
..e.e@..@e.e@.e.e@e........@e@@ee@..
w.@e.e..e@.ee..e@......e@e.e@@e.ee.w
..e...@e@e.@eee....e....e@...e@.@e..
..@e.ee@@e.e@@@e..e@...........ee@..
w..@e@e@e@e@.e@e@e@...e.e@@ee..@e@.w
.....e@...e@ee..@e....@@eee.@..e.e..
...e@e..e@@e.@e@e@....eee@e@e@......
w..@e...@e.e@e@..e....@e..@..e@e@e.w
....ee......e..e@@@ee.e@..e..e@ee@..
..e@@@e@.e..e@e@eeee@.@e@.@e.@.e@...
w.@ee@eee@..e@e@e..@@ee.ee@..e.@.e.w
..e.e@e...e..e@e@..ee.....e....ee@..
..@e.....e@ee@.........e@e...e..ee..
w.@e....e@e..ee....e.....@e.e@.e@@.w
..e..eee@.@.e@@e@ee@e....ee@e.eeee..
....e@@e@.e@e@e.e@@ee....@@e.e@@@e..
w.....e@e........e@e@.e@ee@.@e@ee@.w
...e@e.e@...e......e@.....e.e@..e@..
.........e@e@...e@..e.e...@....e@e..
w.e@e..e..e@@e.eee...e@@e@e.eee@@e.w
..e@e.e@....e@e@@e.....e..@e@@e.e...