33,36
365
365
1000
..e@.e.....e@@e....@e@ee@e@.@e.e@...
w..ee@..e@e@ee@....e..@e..eee...e..w
.....e.e@.e@e.e.e@e.....e.e@@e..@e..
.....@e...@eee@e@.ee.e..@e.@e@......
w.e@e..e.e.e@e.e@e@@e@.e@@.ee@.e...w
..e@ee@@e@.@e.e.e@..@e.@ee...e.@e...
..e@@.ee@e.e@.@e@...........e@.e@...
w..eee..e@.@e.e.e...e..............w
.....@e.@.e@.e..@e.e@@e..ee@e.e@e@..
....ee..e..e.@e@.@.e@e..e@e.e....e..
w.e@@@@ee@e@.e@e.ee.@e....@.@e..e..w
...eeee.@e..e@e..e@.e...e.ee@e@e@...
...e@e@.....e@@.e.e...e.@e@..@ee.e..
w.e@e@@ee@e@eeee@.@e@.@..e.....@e@.w
..e...e@@ee@...e@e@.e.e@e@@e...ee@..
..@e..e.@e@e.....@e....@e@e@.e@e.e..
w.@e.e@.e.e@e@e@e@....@e..ee@..e...w
..eee.....@e@e.e@e....e.e.@.ee@@.e..
..e@@.e@.e@e@@.ee.e@eee@@ee...ee@@..
w...e..e....ee.@@e@e.@@e@ee.e@eeee.w
.....e..e..e@..e.e@@.e.e@e@...e@e...
..e..@e.@e..@e....ee@e@e@.....@ee...
w.@e@e@e@@..e@ee.e@.e.e@e.....e@@e.w
..e.e...ee@..e@@ee@.@.e@......e@.e..
....e.....e..ee@eee.e..e@...e@ee.@..
w.e.@......e.@@e@@.....@e.@e.....e.w
..@ee......@eeee@e@.e...e@ee..e.....
..e@.e...@e.ee@@@ee.@e@...@@e.@.ee..
w...e@e..e.e@e.eee...@e...e@eeee@@.w
...e..@..e@@....e@ee........e@e.ee..
..e@@ee..eeee....e@@e...e...@...@e..
w..ee@..e@@e@e...e@@e...@e..ee.ee@.w
..e@e@e.@e..e@....ee...e@e...@e@....