33,36
359
359
1000
..ee@.e@@e@e@@ee@ee@e.e@e@ee.e@ee...
w.@eee@ee...ee@e@..@e.e@e@@@eee@@e.w
..eee@@e..e@....e..e...e.ee..@e@@e..
..@@e@e....e@e.....e@e.@e...@e.ee...
w.ee.......@e@e...e@eee..e..e@.....w
...e@e.....ee@@eee..@@@..@..........
..e..e.......ee@@@e.eee@ee...e......
w.@@e@.........ee..ee.ee@e...@e.e..w
..eee@@e.....ee@@e@@@e@@e@..e@ee@e..
..@e.ee......@e@..ee..e@ee..@e...@..
w..e@.@e...e..@eee@...e@e@..@e@e.e.w
...@e...e.e@@e@e@......ee@..ee@.....
........@.e@e.e..e@@e...@e..@.ee....
w...@e..ee@ee@e..@ee......e@eee@.e.w
....e@e..e@@e@@eee@....ee.e@e@@ee@..
...e@e@e@ee..e@@@......@@e.e.@e@.e..
w....e.e@ee@e.eee......e@@.@ee..e@.w
.....@e.e@e@@e..........ee@.e...e@..
....e...e@ee....ee.e@....eee@.e@.e..
w...@e@..e@@e...@@eee@ee@@@@e.@e...w
...ee.e.e@..@e..e@e@e..@eee@e..@e@..
..e@@...@.e......e.e@e....e....e.e..
w..@e@e@ee@....e..e@..e...@e..e@e@.w
...e.@ee.e@e...@e..e.e@....@e.e@@...
.....e@..ee....@e@e@e....ee@@.@ee...
w.e.e....@@e...e..e.@e..e@eee...@e.w
..@.@....e@e@e...e@......e@@....@e..
..e@e.e@@ee@.....@e..ee@e@ee@e..e...
w...e..eee..e....e@..@@e.e@..e@e...w
....@e.e@@e.@e....@e.eeee@...ee@e...
...@eee@e@@e@...e@e..e@@e....@e.@e..
w.eee@e@eee@e..e@@e@e.ee.......e@..w
..@e@........e@e@e.e@e@@e..e@e..e...