33,36
365
365
1000
..e@.......e........e.....e@e.......
w..e......e@e.....e@@e@e@e.@e......w
..e....ee@@e@...ee.e@@.ee@.e...e@e..
..@e..e@@e...e@.@@e.eee@@e.@e.e.e@..
w......e......e.ee@..ee@@e...e@.@e.w
..e@e.e@..........e.e@@ee.......e...
..e@e@@@e@e.e@....@..e@ee@e..e.e....
w..@eeee.@e..e@e.ee..e...@e..@e@...w
...e@..@.e@....e.@e.e@@e@e.....ee...
...e@e.e...eee.@.e@e@@e....ee.e@@e..
w.@ee@@e..e@@@eee@e@.e@....@@ee@.e.w
..e...e.....eee..ee...ee.e@e@@eee@..
....e.ee@.e@@@@ee@@e..@@ee@ee...e@..
w.e@@e@@e..eee@ee@e@e.e@.@e..eee.e.w
..@e@.e@e@eee@@e.ee@@.@ee@@e.@@@e...
...ee.e@@ee@@eee@@.ee....e.e@ee.....
w..@...ee.ee@e@.ee.e.@e.e.e@..e....w
..@e@e..@.@e.......@ee..@ee...@e....
..e.e...eee@eee@eee@eee@e@@e.e......
w..e@e..@@@e@@@e.@@ee@@@e....@.....w
...@e...ee...ee@.e@.@eee.....e@.....
..e.....e@....e...e.....ee@e@ee.....
w.@e....@e.e.e@.....e...@.e@..e..e.w
..@e@e.....@e......e@.@ee@....@e@@..
..ee@@e.e.e@e..@ee@e@@e..e....e.ee..
w...e...@......e....ee...@e@e.e....w
...e@..ee.e..e.@e@e..@.....@ee@e.e..
...e.e@@@.@e.@e@e....e.....e@@@ee@..
w..@.@eee.e@e@ee.....e@ee@...ee....w
..eee@@e.....e@@ee...@ee.e.e@@ee....
..@@.e@e.e...e..e@@e.e@@..eee..@e...
w.ee.e@@e@ee.@ee@@e.e..ee@@@@e@@e..w
..e@e@e..e@@ee@..e.e@e@e.eeee@ee....