33,36
365
365
1000
..@e....e.eee@e....ee@e@@e..........
w.e@.e@e@.@@e@e...e@.e.eee@e...eee.w
.....@e...e@e..ee.e@e@@e@@e@...@@@..
......e..e@e@.e@@e@@e.e.ee..e..eee..
w.e@e@@e@e@e....ee.e...e@@..@e.....w
..@eeee.e@e@.@e.@@e.e@e..ee....@e...
..@e@@...e...e..e@ee......@e...e....
w.e.@e..e@......@e@@e.e.ee@eeeee...w
..e@e@e@@e....e@e.....@e@..e@@@@....
..@.e@ee.@....@ee@....ee@e...eee....
w.ee@....e...@e.@ee@e..e@@..@e...e.w
.....e@...@e.e.e.@@@e...ee@.e..@e@..
.....@e@eeee@.e@.eee..e...e.@e.e@...
w.e@e....@@.e.e@..@ee@@...@e@...e@.w
..e@e....ee.@e.ee@e@.eeee.e@e..e.e..
..@@e.e..@e..e@..e.e@ee@@ee.e@e@.e..
w.ee..@.e@@...e....e@e@..e@ee...e@.w
......e.@ee.....e@ee@e..ee@@@e.e....
......e@e@e.............@.ee@e.@e@..
w.e..ee@.e@e@e.e@e@.@e@ee..ee@..ee.w
..@ee@.e..e.......e.ee@e@..@..@e@...
....@e.eee@....e@e@.e..@e..e..e.....
w......@@@e....e@...@ee@@e.@...@ee.w
......eee@e.....e...@e.e...e@..e@@..
.....e@.e@e.....e...e.@ee@e.e...ee..
w.e.e@e..e..e..e@e.ee.e.ee@e@e@e@..w
..@@ee@.e@.e@e.e@@e@@e.e@@..e@@e....
..ee....e@e@e...e@@@e..@ee@ee@e.....
w....eee..ee@e@e.eee..ee@..e@..e@e.w
.....@@@@e@@e..@ee...e@.....e@e@e...
..@e.eeee.......e@@ee......e@e@e@...
w.eee..e.e..ee..e@ee@@ee.ee@@e@....w
..e@@e.@e@.e@@e.e@e..e@@e@..e.e.....