33,36
359
359
1000
...e@e@....ee@ee@e...e..e@ee@.......
w..@@ee..e@@@ee.@e...@ee@e..ee.....w
...ee@....ee..@@ee@......@e.e@e.....
...@@e..e@@.e.ee..ee.ee.e@e.@e@.@e..
w.ee@....eee@.e....@e@@e...e@e..ee.w
..@ee...ee....@.....e@...e.e@e.e@@..
.......e@@e..ee...e..e...@e@e@ee@e..
w...e@ee@ee@e@...e@...e@.e@...@e...w
...e@..e@e.e@e.e@@e...@e..e....e@e..
...e@e.@@e...@@ee.@.e@@e..@e@....@..
w.@e...ee....ee@e.e..ee...e.e.e..e.w
..e@.@e.e...e@.e@..@e@@.e.@e@e@@ee..
...@ee@e@e@.e..@e..e..ee@..@@e@ee@..
w..e.e@ee.e.@e.....e.ee@@e.eee@ee@.w
..@e...@@e....e..ee@.@e@e..e.e@e@e..
..e....e@e....@e@@...e@.@e@@ee@e@...
w............e@.ee.@e@ee@eee@@@ee..w
......e@e.e@e.e.e@.e.e@e...@eee.@e..
......@e..e@ee@..e@..@.@e@e@.e......
w....e@e..e@e@e...e.ee.e...ee@@e...w
...@e.@e..@e@.@e@..e@e.@e.e@..e@.e..
...ee.ee.e@eee@ee...e@..e.....@e.@..
w.ee@.e@@ee@@e@ee@.e@..e@...e@e..e.w
..@@e.@@e..e@e@e.e.e@.......e@@ee@..
..e@e@ee.e@e@..e@@e.eee.....@e..e@..
w.....e...e@e...ee@..@@e....e....e.w
..e@e@@e.@e.@e..ee.e@e.e....@e......
...@ee.e@e.e@@.e@@e@...@e...........
w..e...e@e@eee.e@@e..@e...ee..@e.e.w
......e@@e...@.@ee...e@@e.@@e.e@.@..
..e@..@ee....ee@....e..e..e.e.e..e..
w.@e.e@e@...e..ee...@e@e...e@e@.e..w
..e...e@....@e.e@..e@ee@e@e....e@...