33,36
348
348
1000
...ee......@e@@ee@e@e.e@@ee@e...e@..
w..@@..@ee@e.ee@.ee@..@ee........e.w
...ee.@e......e.e.@e...@......e..e..
...@..e@...e@e@e@...eeee@ee@..@.e@..
w.ee....e@e..e@e....@@@@ee.e@eee...w
..@ee@e..e@e@......@eeee@@e....@e...
..@ee@e..@@ee.e@ee.e@@ee@e...e@.....
w.e@.....eee@e..e@.e@@e.e@...@e@e..w
....e@..@e.@e@..@@e@ee.....e@e.e....
...e.e..e@.ee@..eeee@@ee...e@.e@@e..
w.e@e@@e@e@e.e....@@e@.@e.e.e..ee@.w
..@e@ee@ee@@.@e...ee.e...e@@e..@e...
..e..@ee@.ee..@e...e.e.....e@@e.....
w.@@e......e@e..ee@@e@.ee@e..e.....w
..ee..@e@e..e...@.e..e@@@e....e@....
..@e..e.....@..ee....eee@ee.@e@e....
w..@..@e.e@ee@.@..e@e@ee@e@.e..@e..w
...e...eee@e@e.e..e...@.............
....eee@@@..e.....@ee@e.e....@e@....
w.e@@@e@ee.e@ee....@ee@e@....e.e...w
...ee@ee@@.e@@@e...e@@......e@...e..
....@e@..e@eee.@e.e@@e....e@...e@@..
w.e@e..e.e@e........ee@ee@ee...@ee.w
..@e..e@ee..e............e@..e......
..e....e@@..@e......e..@e.e@e@eee@..
w.@e@e.e@e....e@.@e.@e.e.e@.ee@@ee.w
..e.e@.e..e@ee@e.e@.ee.e....@@e@e...
..@.e..@.....@...e@.@@e@....e@e@e...
w.e.@..e@ee@.e....e.ee@@e....ee@...w
....e..@e@@e@e...e@.@..ee@....@e....
....@e.e....@e@e@@e.e.e..e....@e....
w.e.e@......e@..ee@@ee@.ee@e..ee@e.w
..@e@.e@e........@ee.@ee@@ee@e..e@..