33,36
360
360
1000
..e.e.....e@e.@e..@e.e.ee....e...e..
w.@.@....e@..@e...e@.@e@@...e@..e@.w
..e@e...ee.@eee.......e@e.e@e.......
...eee.e@@eee@@e..e@e...@e..........
w..@@@ee@e@@..@e.e@@e..e@@e@e......w
...ee...eeee..e.ee@e...@e...ee@ee@..
...@@e@ee@@e....@e@e......@e@.e@@e..
w..e..e@@e...@e..e@e.e@..@e..e@e@..w
..e.....e@e..e...e@.e.e.ee@...@ee...
..@e@e.e@e@.......ee@e@e@@@e..e@@e..
w.e..@e.eee@e@ee@.@e@e.e@ee........w
.......e@@e@e.@.e.ee@e.@ee...e@.ee..
..@e.........@e...@@e..e@@e...e.@@..
w.e....ee...ee..eee@@e..e@e@@e..ee.w
....e@e@@.e@@e.e@@@e......@ee@...e..
..e@@ee@e..e..e@ee.....@e....ee@e@..
w..e@ee@@e....@@e@....ee.....@e@@e.w
.......e......ee.....e@.....e..eee..
..e....e@@e@e.@e.e@..e.@e...@.e.e@..
w.@e....ee@.......e..@@e@..@ee@@e..w
..@eee@eee....e....e@ee....ee@.e....
..e@@..@@@e.e.@e.e@e..eee@e...e@....
w..@e.@ee..e@..@e.....@@e@e..e.e@e.w
..ee..e.e...e@e......eeee@@ee@..e@..
..@e..@e@.eee@e@e....@e..eee@.e@e...
w.e..eee@e@@e.@e@@e......e@.....@e.w
..@@e@ee@ee.e@e..e@e....e@.eee.e@e..
..ee..@ee@@ee@@..e@@e...e@e@@@.ee@..
w.e@...@ee@e.ee...e@..e...e.ee.@ee.w
...e@..e@e@@e@@ee@.e..@@ee@....@e@..
....e..@eee@@e@e.e....eeee@ee@ee....
w.e@e..e@@eee.e..@..e.e.@e@e.......w
...e@e@ee@e...@e.e..@e@.e...........