33,36
350
350
1000
...eee@e@e...e@...e@eee@@e....e@....
w.e@@e@.e@....ee..ee@@eee.ee@e.ee@.w
..e..@ee@.....@@ee@.....e.@......e..
..@e...@..e@..e@e.....e.@ee.@e......
w.@e...e...ee.........@@e@@eee@e...w
..e..e.....e@...e....@ee..@ee@@e@e..
..@e.@..e..@ee@e@@e..e.@..e.@ee@e@..
w.@e@e..@ee@ee@@ee..e@ee..e.e@...e.w
..e@....e@.@e.e....e@@e.ee@..@e@e@..
.........e@e@.e@e....e..@@...e@@ee..
w...e...e@.e@.e@e.......ee...e.ee@.w
..e.@eeee..@e@@e......e.....e@..@e..
..@e@e@@@e..ee..e....e@..e@.@e..ee..
w.e@ee@e.e..@e..@e...e@.e.e.e@.e@@.w
..ee.@e.e@......e@....e@@...@e...e..
..@@e@@ee@.....e@...e@.eee@.e@......
w.ee.ee@@e......e@e.ee....e........w
......@e.@..@e..@...@e@e.e@....e@...
..e...e@.ee@e...e..e@e..e.e.e...e...
w.@ee@@...e.@e..e.@ee...@e@.@e@e...w
.....ee@.e@..e@.@eee@eee@...e.@e@e..
....e.@e@e@@e@ee@@@ee@@.e.e...e..e..
w...@e@e..ee....ee..@@e.e.@......@.w
....e@ee......e...e.ee.e@@e......e..
.....e@@e.e...@e.e@.....@e.ee@e..e..
w.e@..@e.e@e......@e....e.e@e@@e@@.w
..@e.ee@.@ee@e....eee@e.@e@..ee@ee..
..@e@@e..e@e@....e@@..@ee@e@e.@@e...
w.e@ee@..e@ee......ee.e.@e....ee.e.w
...e.@.ee@@e...@e...@e@..e@.e..@e@..
...@.ee@@@e.ee@e.ee@@e@.e.ee@e.ee@..
w..e.@e@ee.e@.e@e@.ee.ee@..@e..@ee.w
..e@..e@e@.e@e....e@@e@@e..e@...@e..