33,36
352
352
1000
..e@e@e..e@.e@@e..e@e@ee..e@e@e.....
w..@ee@..@e..ee@@e.e...@..@e....e..w
...e..@e...e@e..e@e.e@ee@e.e@e..@e..
....e@e....e.e@e@.@......e@e@@...@..
w.e....e@e.@e@..eeee......e@eee..e.w
..@e..e@e@.e...e@@@@e@e..@eeee@.e@..
.....e@@ee.@ee@..eee@....e@@@@.e@...
w...e@ee@@e@e@e..@@........eee.....w
...e@@e..ee@e...eee..e@ee.e.e@......
.....e@e.e@@e...@e...@ee@e@.....@e..
w.e@e..@e.ee.e@e@@eee@@@e@@e....e..w
...@e..e@e@...e@e.@@eeee..e....e@...
...e.....e@e@e..@.e..@@e..@e...e@e..
w...e@eee@......e..@ee.......e.@e..w
..e@ee.@e.....e...@e....eee..@ee....
..@@e@....e@e.@ee@e....e@@@@e.@@e...
w.eee.ee......e@..e@e..e@eee..e@@..w
....@e@@ee.e@e....@e........@e.eee..
..ee@.e@e@e@..........@e@e..e...@@..
w.@ee.@e..e@.......e@ee@.@......ee.w
....e@e....e.@e..........e......ee..
..@e...@e...ee.e@....@e....e@e@e@@..
w.ee...e.eee@..@e...ee.e@@e.e.e@@e.w
..e@....e@@e@e@e..ee@@..ee@..@eeee..
........e@e.e@e..e@@@ee@@.@e.ee@e@..
w.e@.@e.....ee@...@ee.@eeeee@ee@.e.w
..ee@e@e...e@@....e....@e@.....ee@..
..@e.e@@e..e@e@ee..e@eee.e...e.@@...
w..e..e@ee@e@.e@@e....@@.@e..@eee..w
..e@..e@@e@@e.@e@e....eee@e....e....
.......e..e..e@e@e...e@.@e...e@@e...
w............e@e@e.ee@@e@e..@eee@..w
....e@e...e@e...e@e@e@e.e@..e@.@e...