33,36
360
360
1000
..e@e@@e@..e@@e......e@ee@e..@ee@e..
w.e@eeeeeee.eee.e@...e@e@@ee@ee@...w
..e@@@@@.@@e.e@..e....ee@e..@eee....
...eeeee@ee.e@.e.e@....e@ee.e@@@e@..
w..e@..e..@.@e.@e.e..ee@.e@@e.e@ee.w
..e@@ee@.ee@ee.e@...e@@.e.@e@.e@....
..@.e@@ee@e@e@.@e@....e.@.e...@ee...
w.eee.ee@e.@ee@eee.@e...e.e..e.e@..w
..e@@e@e@@ee..e@@..e.e@e.e@ee@......
..@e....e@e...@@e...@e@..e@@e@e@e...
w.......ee@..eee..eee.e...e@..e@@..w
........@e@.e@@..e@@@e....@ee@eee...
..e@e...e.e...e@e@.e...e..e.........
w.........e....e@@e....@ee@...e....w
..........@e.....ee..e@e@e@e..@.@e..
..e@...ee.e@..@eee@......@....eee...
w..e..e@@ee@e.ee@@ee.e@.ee..e..@e@.w
..e@...@ee..ee@@e@e@..e.@ee.@e.e.e..
..@@e.ee.@e.@ee@eee@e.@e@e@e@e@@e@..
w.eee.@e.e@e..e@e.@e@..@e.ee.@ee...w
...e@e@ee@.@@e....e......e@@..e@.e..
...e@@e..e.eee@...e@......@e@ee.e@..
w..ee.e@e@.e@eee@.@e..e@e@ee@e@....w
..e@@e@e..e..@e.e@.@e.e@e@e.e@e@e...
..e@e.eeee@@e.@e.e..e....@e.e.......
w.@...@@@e@e..e....e@@e..ee.@ee....w
..e...eeee@@.e@......e@.e@@e@.@.....
......@e@eee...e@e@e...@e...e@e.e...
w......e@@e@.....e@e.e@e........@e.w
........e@e.....e@@ee@.....e@e..e...
..e@..............e........e...e@e..
w..e@e@.e@..e...........e..@e..@e@.w
......e..e.e@.e@ee@e...e@..e@..e....