33,36
370
370
1000
......e@e.e@..e@.ee@ee@.e@...e@ee...
w....e@....e...e.@e@@.e..e......@e.w
....e.@e@e...e.e.e.ee....e.@ee@e....
..ee@.e....e@@.@.@e@...e@@@e....ee..
w.@e@e@.e...ee.e.@e....eeee....e@@.w
.....@e.@e@.e@...e.@e.e@...e@@e..e..
..e..e@.eee.@......eeee@e...ee@.@e..
w.@.ee..e@@ee..e....@@@ee@e...e@ee.w
..ee@@e..e@eee.@ee@eeee@e@ee@e..e@..
..e@e@...@.e@@e..@e@...@e...@e..@...
w....e.e.e@e@e@e...e...ee@..e@..e..w
...e@..@e.e.ee.@e..@ee.@ee..........
....e.e@....@@e..e@e.@e@e...e..e@e..
w.e.e@.ee@..e.e..@ee@e@e@e..@.e@.e.w
..@e@e.@ee..@.@e@e..e....@e@e@ee@@..
.....@e@....e.@e......e@@ee@.e.eee..
w...e@ee......e.....@e.ee..ee@e@@..w
....@e..ee@e.....e.ee.e@ee..@e.ee...
......ee@....e..e@e@....@@.eeee@@e..
w....e@......@e.@@ee.ee@eee@@@@@e@.w
...e..e@....e...ee@@.@ee@.e@eeee.e..
...@...e....@.ee...e.e@e@e..e@.ee@..
w.eeee@e....ee@@.....ee@..ee.e@@@e.w
..@@@@.e.....@ee..e..@e@ee@@.@eee...
..eeee.@.@e..e@...@ee@ee@@ee....e@..
w.@@e@.e.e..e@.....@...e@@e@.e@..e.w
..e@@e@..ee.ee...e@e.@e.ee....e.....
...e..e.e@@e@@e....@ee.ee@....e.@e..
w.@e.....e..e@@e.ee@@@e@@e...e@.ee.w
..e...e.e@@e@e...@eeee...ee...e.@@..
......@e@@e@ee@..e@@e@e..@@e..@eee..
w.e@eee..ee@@@e.e@e@e.@eee...e@e...w
..e@e@@e...ee......e@e@e@e@e.e@e....