33,36
240
240
500
......@e@e......e@.....e@.e@....@e..
w..e@ee..@ee......@e.@e@@ee@.......w
...@e@@@ee@@@e..e@....ee@@e.....e...
..@e....@.e@.e@.@.....@.ee...ee@@...
w.@.@...e...@e..e....e@e.@.@.@.....w
..e.e......e@..e..e.e@.@...e.....@..
...@.@ee..ee..@@..@.@@.e....e.e..e..
w..e...@@.@@eee@.@e.@e.....e@.@@e..w
..@e...@e@e.@@@e.e@.e...@..@..@.....
.......e......ee........ee.ee@e.....
w..............@...e@e...@.@..@e...w
..@e.......e.......@@e..e....e@@e...
..@@...e@e.@@.@e@@..e@.e@.e.ee.@.@..
w.ee.....@@ee...ee.e.e@@..@.@@.e.e.w
.............e...@@@e....e.......e..
.....@.......@@..ee.@....@..@e.@e@..
w....ee.......e..@..e@e@e..@@e...@.w
......@@@e.....e@ee@e.@e@.ee...e@e..
..@....e.@@...@e@@@.....@e@.e.......
w.e..e@..ee...e..e.....e@e@.@....e.w
...@e@.........@e@e..e@e@........@..
...e@e......@e.e@@e@e@e...e@.e@e....
w..@.@e..e......@@e@e@@@@ee....@@e.w
...e@....@@ee@..e@e@eeeee.@....@e@..
..e@e@e.e@@@...@ee.e@@@.@.@e...@.e..
w..@e..e@eee...e@@@@eee...@..@ee...w
......@@.....e..@ee...e.@.e@@.......
...e@.e@@.@..@e@....@.@.e..ee@e.....
w.@e@..ee.e....@e...e....@e.e@@e@..w
....e....e@.e@.@......e@.e@.@e..e...
..@e@..........e.@e@@e.e@....@e..e..
w.@@e..e@..e@...@..e.@.@e...e...e@.w
..ee.e@..@e.....e....e.e@...@...@...