33,36
352
352
500
........@e@e......e@@e@@ee@@e.@e....
w..e....ee@e.......ee.eee@ee..e@...w
..e@....ee@e.e....e.ee@e@@e.....ee..
..@eee@e@..e.@...e@.@....ee..e.e@@..
w..e@.ee@..@ee.e@e@ee.....@ee@@e@e.w
...e..@eeee@e..@e.......e@eee@e.....
..e@ee@.e@@.@ee@e@......@ee@@e@.....
w.@e@ee..@e@.ee..e@e..e....e@e.e...w
..@ee@@..e.e@@@e...@..@....e..e@....
..e@e@e....@ee@...@e..e@e@.@ee@@ee..
w...e@@.......e@..e.e@ee.e..ee@e.@.w
.....ee.e@....@e...@ee@@@e.e@@e..e..
..e@..@eee...@e.e@ee...eee.e@ee@e...
w.@e.e@e@@e..e...eee@e..e@...@@e@..w
.....e@e.@e.....e@@e@.e.e@e..e@e@e..
.....eee@e@...e...e.e.@@e@@e@...e@..
w.e.e@@@eeee@e@.eee...ee.e@ee......w
..@.e@e.@@@@e..e@@@......e@@e.e@e@..
..e..ee@eee@.e...ee@..ee@.e....@ee..
w....@e@@eee@@@e.@@e..@@e......e...w
......@e.e@.eee@ee....e...e@..ee....
...e.e..e@......@e.........e.e@@e...
w..@e@.e@@e.e@e.....e@.e@e.ee@e@ee.w
..ee@..e@e....@..@ee@e.@.@e@e@ee@@..
..@e..........e..e.@e.ee.e@e.e.@ee..
w..e@....eee..e.....@e@@eee@.@e@e..w
....e...e@@@e.@.....e@@e@@e.e@e.@...
..e@@e....e@@ee@e..e@eee@e......e...
w..ee@e@e..e@e.e@..@e.@e@e@...@e...w
...e...@e..@e..e@e....e.e.ee..e.....
..e@...e........@e....@..e.@e@@ee...
w.e@@e........e@e.ee..e.e@e@ee.e@..w
..@ee.........e@ee@@ee@....e@.......