33,36
361
361
1000
...@ee@...e.e..e@...e@ee...@e.......
w..e.@ee..@.@..@e...e@@@...e@e...e.w
...e...@.ee@e.@ee@e@eeee....e@e..@..
...@..@e.@e@.@eee@e.ee...e@e@.@e.e..
w..e..e....e.e@@e..e@@e.e@.e@@e@...w
..@ee.@e@......@e@.e@@e.@...ee.e@...
..e.@e..e@@e...e.e..eee@e@.ee@e@e...
w...e@e..ee.e...e.e@e.@e.e.@.@e@@..w
...ee@@.....@e..@.@ee.ee.@.e@e.ee...
...@eeee..e@@e..eee.@e@@@e..e@......
w.....e@e.@eee@..@ee@..ee@..@e.e...w
..e@..@@e.e@.ee.....e.e@....e@.@e...
..@ee.eee@e@.@e...e........@ee......
w..@@e.@e.@e......@e@.....ee.@ee@e.w
...ee@..@e.....e@e..e@ee@.@e........
..e....@e@.......e..e@@ee..ee.......
w.@..e.ee@ee.e..e@..@e..e.e@@ee....w
..e@e@....e@.@e.......e.@e...e@e....
..e@e@..e...e@...ee...@e...@e@......
w.@eeeee@@e..e.ee@@@e..e@e.e..e@ee.w
...e@@@@ee..ee@@.eee..ee@@.e@e@e.@..
...e@ee@ee..@eeee@.e@e@.eee@e....e..
w..@e..ee@.@e@e@....e.@e..e@ee@ee..w
..e@ee..e..e..@...e.@ee@.....@..@e..
....@@..@ee@..ee@e@e@eee...eee..ee..
w...ee@ee@e@.....e...@@@e.e@@.@e@@.w
...........e@e..e@...ee@e@e.e.e@@e..
.......@e@e.....eee...e@@...e@@ee...
w..e...e@@e.ee@e@@@ee@eee....e.@e..w
..e@....@eee@.ee@ee@e@@@e@.e@.......
..@e.e..e@@@.e@.e.@e.eeeee@eee@e....
w....@....eee...@e@ee@.@@e@e...e.e.w
.....e..e@ee@ee@e..e@..e......e@e@..
