33,36
361
361
1000
..e@ee@e.e@e...@e@..e..@e@..e@e.e@..
w...e@@e.@.....e.e@.@@ee.eee.@ee.e.w
......e@.e...e....e.eee@ee@@eee@....
...ee@e@ee...@........@..@e@e.@e@e..
w..@e@.e@@...e.ee...e@e....e@.e....w
...e.e.e.e.....@@e....e@e...e@@e....
..e@.@e@.......e@e@ee@ee@...ee@.....
w.@@e...e..@e.@e@.ee...@e...@eee...w
..ee....@e@e..e@ee@@.........@e@.e..
...@e@e.e.e@......ee....e@e@ee@ee@..
w...ee@.@.....e...@ee@...@ee.ee@...w
...e@.e@ee@.e@@.e@@eee...ee.e@@.....
...@e.@e@.e..ee@eee.@@...e@e@ee.e...
w...e...e...@e..@.e@ee@.@e.@..@e@e.w
..e@@e.e.e@ee@e.e..e..e.e..e...e@@..
...ee@e@e@.e@...e@e@......@e.e@eee..
w..e..e.@e.@e@e..e@.......e..@@e@e.w
..e@..@..ee@e....e..........eee@....
...@e.e@e@e@@e@..@.....ee..e@.@@e...
w..e..@e...e@.e..ee@ee@@@@e@@eee...w
.....eee@e..e..@eee@..eeee.@e@@@e...
....e@@.e@.....ee@.e...ee..e..e.....
w.e.@.e.e...e..e..e@e.e@@e@@.@e.ee.w
..@ee.@.@e..@..@@e@e@...e.ee.e..@@..
..e@..e.....e@@ee..e@e.e@e@@e..eee..
w.e@e.@eee..eee......e.......e@@...w
...e@..e@@..@ee.ee@e.@e@e..e@.ee....
..@e.@ee.e..e@@e@..@e.e.e...e...e@..
w.ee@ee@.@.......@e@ee@.@.e.@e...e.w
...e@e@@ee.e.....e@@e@@eee@@e@......
.......e.e@@...ee@ee.@e@.e@e...e@e..
w..e...e@@eeee.@@e.e@eeeee@@.e.@...w
..e@e...ee@e@@eee@e@.e@e@.eee@.e....
