33,36
354
354
1000
.....e......e.e@e.e@..e@.e@e@e......
w...e@.@e...@ee@e..e@e.e.@ee@e@e...w
....e@ee@e@...e@e...e@.e.ee.....e...
..e@@e..@ee@e@eee@e...e@.@@.e@e.@...
w..ee@..e@e@.e@@e@.......ee.@e..e..w
.....e@....ee.ee.e.e..@e@e.e@@e.@...
......e...@e@..e..e@.eee@e.ee.e@e...
w.e...@e..e@...@.e@e.@e...e@@......w
..@eee@....eee@ee..@@e@e....e.e@ee..
...e@@e.e@e@@@e@@e.eee@@e...e.@..@..
w.@e@@e..eeee@.e......e..@e.@ee..e.w
..e.ee.@e@@@ee.@e....e...e@e@.@.....
..ee@e@e..e....e@...e@e@e@.ee.e.....
w.@@e.....ee@...ee@e..e@e.e@@......w
..e..e@e.e@@e.@e@e@........@ee......
..e@.e@e@e@e..e@..e..e@e.e@ee@......
w..e...e@@e@e@e.e@@e.@e@.e...e.....w
.....ee.ee...ee.@eeee@.ee@@e.@e.....
...ee@@ee.....@e@e@@@ee@@.e@@e......
w..@..e.@...e@e..e@e..e@ee@.e@.....w
...e.e@@e@e.@ee@e..@...e@...e.e.....
.......ee.ee@@e.@eeee@e....e@e@..e..
w..e.e@e@.@.ee.e.@@@ee@...@e@@@e@@.w
..e@.@ee@.e@e@.@eee.e@.e@ee.eee.ee..
..e@@eeee.e@ee.e@.e..e..e......ee...
w.@eee@@ee@@e@.e@.@.e@.e@......@@..w
..@e.....@ee@...e.e.......e@e.@ee...
..e@.e@@e...e..........eee.e.ee.....
w.ee@@ee@e@e@.......e.e@@@.ee@@....w
..@.e.e@...@e.e.....@e@@ee.@e@e@....
..e.......e@e.@e.e@e...e....e@ee@e..
w......@e@@e..e@..e@e@e@...e@@e.ee.w
.......e.e...e@......e.......e..e@..
