33,36
354
354
1000
...e@ee@e.e@e@e@.....eee@.....@e@...
w..e@.e....e.e.eee@ee@@@e.e@e.e.e..w
....e.@e...@....@.e@@ee@ee@@e.e@....
.....e@eee@e....e.@@e.e@@@ee@..e....
w..ee@@e@...e@e.e.ee..eeee@..@e....w
..e@..e.@e..e@e.@ee@..@e@ee..e@e@...
..e@e..@ee.e@@e.e@@@e@eee@@e..@ee...
w..@e..ee@.@eee.@eee..e@@e@ee@ee...w
...e........@e@e@..e...@e...e..@.e..
...@ee@.....e..@e@.@eeee....@.eee@..
w..e@.e@e......e.e@..@@e....e.@e@..w
...e..@..e........e..e.......e@..e..
...@e.e..@e....e@e@@e..e.....@e..@..
w.e@.e@....e@e@..@@e...@e.......ee.w
...e.e........ee.ee....e..e.....@e..
...ee@@e.......@e.@e@..@e.@.@e.e@e..
w..@@.e.....e.ee@@e.e@e.e@e@e..@@e.w
..@eee.ee..e@.@e@e......e@eee..ee...
..e.e@.@@e.@e@.@e....@e@..e@@.......
w.@.e@ee@..e.eee@e.e.e@e...@e......w
..e..@e.e..ee@@@@e.@.e.e...ee..e@e..
.....e.eee.@e.eeee@e@@e@e...@.@e@e..
w...e@e@@@e@..e@@@e.e..e@..ee@e....w
..e@@@e.ee@ee@..ee@e@..e@ee@.ee.....
...eee....e@.e.e.@e@.........e@.....
w..e@...e..@e@.@..ee...e@....e@....w
...@@e@.@eee...e@e@@e...e..e@ee.....
...ee.e...@.e@e.e.@e....@e.@e@@ee...
w.eee.@e..ee@@e@@.e@@e..e@..e@e@@..w
..@@@.....@@@e.ee@e@e.e@ee@e....e...
..eee.e@e@eee....eeee@e@..@ee.......
w.@e..e@@e..@ee..e@@.@ee..e.@.e.ee.w
.......e....e.@e...e@e.@e.e@e.@e@...
