33,36
357
357
1000
...@ee@@e@..@e@...e@e....ee..ee..@..
w..e..ee.e..e.e..e.@e.e..@@e@@@..e.w
...@..e@.@@e....e@.e..@..e@@eee@e...
...ee.@e@ee..e..ee....e@e.e.@@e@@...
w.e@@e.e@e.e.@e@@@e.ee.e..@ee@eee..w
..ee@...eee@.e.ee.@e@@......e@.@.e..
..@ee..e@@@e.@...e@e.e..e....eeee@..
w.@e.....e...e@ee@...@e@@ee.e@@@e@.w
..ee@ee@ee..e@e.....e@.e@e@...ee.e..
..@@...e@@.e@.@.e@e..e...@ee.e@@....
w.ee...@.e.@..ee@.eee@.....@...e.e.w
..e....e.e@e..@e.e@@@e.e@..e.eeee@..
..@......e@eee@...@e..e@e....@@@....
w.e@e...e.e@@@e...e......e..eeee...w
.......e@ee@e..ee@e.....e@..@ee@@e..
.....e.e@@e...e@.....e.e.@e@e@e@ee..
w....@..e.......eee..@e@ee.e..@ee@.w
.....ee.e@e.e@..@@@..e@.@ee@ee@@e@..
.....e@.e....e..eeee.....e@@eee@ee..
w.@e..e.@e...@e@e..@@e.....ee@e@e..w
..e...@ee@eee.e@@..eeee@e...e@e@e@..
..@.e@....@@@e.eee@e@@@e..e.e@.e@e..
w.e..e....ee@ee...ee@e...e@.@e.....w
....e@e.e@e@..@..e@..e@e.@@e@...e...
...e@e@.@e.e@ee....ee@...ee@ee.e@...
w.@e......@e....ee@@e@e..e@ee@@e@..w
..ee@.....e....e@.e.....ee@@..e.e...
..e@e..e@.e@.e.@e.......@eeeee@@e...
w...@e.@e.@e.@e.@......ee@.e@@@ee..w
....e@..@ee.e@e.e@e....@@e@@eee.@...
....e@ee@@@e.....e@....e..ee@.e.e...
w.......eee@e@e@e......e@.e@@e@.@e.w
........@ee@e..e@.......e...e@e.e...
