33,36
368
368
1000
..e@.@ee@ee@e.e@e@ee........e@.e@...
w.@eeee@@ee.@e@..e@@..ee.....e..e..w
..e.@e.ee.@...@e@.@e.e@@ee.e..@e@...
..@.e..@e.e...e.e.e@.@.ee@e@e@e.....
w.e@@e@ee....e@e..@..e..e@@.@.@..e.w
..@e.e..@......@e.e.e@...ee.e.e.e@..
..ee@@@eee....e@e@ee@e...@@ee.@ee...
w...eeee@@e..@eee.e@....eee@@.@e@e.w
.....@e.e...ee@@@e..e@ee@...e.ee.@..
...........e@@@e.e@.@e.@.e..@ee@.e..
w....e@ee..e@ee...e...eee@.e@..@e@.w
...@e.e@@...e..e@ee@e.@e....e..e....
...eee@@e....e@..e@.@...e......e....
w...@e@e...e..e@@e@ee.e.@....e@@@e.w
......e@..e@...ee@@ee@@ee..e..eee...
...e...ee@......e.e..e.@e.e.e@..e...
w..@.ee@.e..e..e@.....ee..@.@e.e@e.w
..@ee@..e@@e@.......e@@@e.e@ee.@@e..
..e......ee.........@ee...e@@@eee@..
w.@@e@e@e.@......e@..e.....eeee....w
..ee.e..e@e....e@ee.e@e@e...e@@..e..
..e@.e.ee.@e@.e.e@e.@...ee..@ee..@..
w..e.@e@@...ee@e@.e.e@e.@@e.e@...e.w
..e.....e........e@e@e.ee@ee@.e.e...
..@.@ee@e........e@@.@e@.e@...@e@...
w.e.e@@@e...e...e.ee@ee@......eeee.w
..@e..ee...e@e.e@......e.eee@.@@@@..
..@ee..@e..e@e@e..e......@@.eeeeee..
w.ee@..e@e@ee..@e@@.e....ee.@@..@e.w
..e@e@...e@e@@e@@eee.eee@e.@ee..e@..
..@e.e.e@e@.@e.e..e@.@@e@e.e.e.ee...
w.@ee@.e@ee.ee...e.e@eee@e.@e@e@@e.w
..e.@e...e@e@@e..@e@.e@.e..e@e..e...
