33,36
363
363
1000
..@e.@ee@.@ee@...e@e@......e@.e.....
w.e..e@ee.e..ee..@e.ee....e@ee@@e..w
..e..@e@..@ee@@e...e@@e.e...e@@e....
..@e.e.....e@.e@e..ee@..@...e@e.....
w...e@e@e.e@..e@@..@ee..e..e@e.ee..w
....@e..@e@....ee....ee..e..e..@@...
..e.e@.e@e...e@e..e.e@@.e@..@.eee...
w.@e@e@@ee@@e.e@.e@e@@e.e@.ee@@....w
..e@@ee..@ee@e@@e@.e@e...ee@.ee.e...
..e.e.@e.....@@e@.@e@e@e@e.e...e@...
w.@e..@e.....ee...e.e.@e@e.@..e@...w
......e...e@e...e...@.e@.e.e...@e...
....e@@e@..e..e@@ee@ee@.e@..e@ee@...
w.e..e..e..e...e@..e...ee@ee.....e.w
..@ee@...e.@e..@ee@....@e..@e..e@@..
..@eee.ee@..ee..e.ee@.......@e.@ee..
w.ee@@.@e.e@@@e@@e..e.e@e..ee@.....w
...@.eee...ee..e.....e@.ee.@@e.e@e..
...ee@@@@ee@.@e@.e..e...@@ee.@.e@@..
w.....eee.e@@ee@e@..@...e....e..ee.w
..@e.ee.@.@ee..e@e..e.e....e.....e..
..e.e@@.e.@e@..@.@ee..@e..e@e@@e.@..
w.@e@.e@e.ee@e.e...@..e...e@eee.ee.w
..e.....e@@e..e....ee@@@e.@@e@@.@e..
....ee..@eee@e@e...e@eee@@eee@ee@e..
w..e@@....e@ee@@e.e@.@..ee.....e@e.w
..e@ee.....e@.ee@.e@@e.e@..e@e@e....
..@.@.........e@...ee@...e.e@e@e....
w.e@e..e........e.e@....e@e.e@@ee..w
...e..e@.e@..ee@@....e.e@e@e..e@@e..
..e.e.e.e.e..@.ee.@ee@....e...e@.e..
w.@e@e@e@..@eee..ee.@@eee@@e...ee@.w
.......e@e.e@e@.e@..eee@.e.....@e...
