33,36
376
376
1000
.....ee@e@.......ee@@ee.e@..ee@@e...
w.e..@ee.e...e...@eee@@e.e.e@.ee@..w
..@...e......@..e@e...e....e@..@e...
..e.ee@.e@e@eee@ee..ee@....ee...ee..
w...@ee@eee@@....@..@@.@e.e@@eee@@.w
....@e@@e..ee.ee@e@eee.ee...e.@..e..
..e@ee@e....@e@....@.@e.@e.e@eee@e..
w..e..ee.e....@e...e.eee@..e@@e@e@.w
..e@.e@@e@e...e@...e@e@.e...e..e....
..@e.e@@e@@...e@e...e.@ee...@.e@....
w.e@.eee.ee...e@e.....e@@...e...e..w
.....@e..@...e@....@ee@.ee....e@@e..
...e.e@e.e@.e..e@@ee@..@e@..e@@ee@..
w.e@ee.@e@e.@e@eee..@e.e.e@e.e@@.e.w
...e@@ee@.....e@..e@e.e@@e@e..ee....
..e.e.....e@e..e@e@...@ee......e@e..
w.@e@.....e@e@e.......e@@ee....e@@.w
..@e..e@e..e.@e....e..ee..@.e...ee..
..ee@e.@e.e@.e..@e.@e.@@e.ee@..e@...
w.@@e..e.e...e@ee..e@.e.e@ee@@e....w
..eee.e@.@....@e..e@e..@e.e@ee.e@e..
...e@@eeee..eee...@e@..ee@eee....@..
w..@ee@.@eee@@@..ee.....e@e@@ee@ee.w
....@e@...@e@eee.@@.e@e@e@e.e...e@..
...eeee..e.e@ee@@ee.....e@e@..e.....
w.e@.@...@.e@@e.ee..e.e@ee.ee.@e...w
..e@eeee.e..e.@e@@..@e@e@@ee@e@e@e..
......@@eee...ee@e.e@@e..e@@@ee.e@..
w.@e..e@@@@ee@e.e...ee@..@eee@@..e.w
..e@...eee....ee@...e@ee..@.e.e.....
......e.......@e@....e@@e.ee@e..e@..
w.e@ee@.........e...e@....e.@e.e.e.w
..@e......e@ee@e@...e@e...@ee..@e@..
