33,36
360
360
1000
...ee.e.e.e@e....e@@e@eee@e..@e.@e..
w.e@@.@e@eee.....@eee@e@.e..eeeee..w
..@.e.e@.e@@e.........e....e@e@@e@..
..e@e@@...e@e.e......e@@ee@@@e@e.e..
w..e.ee@...e@.@..e@e@..e.@eeee@e@e.w
......@e@e.e..e...e.e@e..ee@@.@e@e..
...@e@@e...@ee@e..e......@eeeee.e@..
w..e.ee@.@e.@e@@e.@ee....e@@e@e....w
...@e....e.e@.ee@.e@@e.e@@eee.@.....
............e@@ee.ee....e.e@@ee.....
w.e.......e.@e@e@.@@e.e@e@......e..w
..@e.e....@e@e..e.e@e.e@ee......@...
..e.e@@e@@e...ee@.e@.e@........@e...
w.@ee@e.ee....@@e..e.@e.e@@e@e@ee@.w
..e@@ee@e@...ee.@.e..e@e@ee@e.e@.e..
..@...@e.@e..@eee.@...e@......@.....
w.e..e@.ee....e@e.ee@e@.......e....w
..@e@ee.@.e@e..e@....@e...e@e.......
...e....e.....e@..ee@e@..e@@e...e...
w.e@@e@e......@e..@ee..e.@eee..e@e.w
..@ee..@..e@ee@eeee@@..@e.@e@..@e@..
..e....e......e@@@e@ee..@eee...@e...
w.@e@..@@e..ee.@eeee.@ee..e@e@eee..w
....e@eee..e@@.ee@@@e.@@.e@e@..e@...
....e@@e@.e@@e..@@ee@.ee...e@..e@e..
w...eee...e.eee@ee@......ee.e@.....w
....@e@...@..@e..........@@e.e.e....
.....e..e@e.@e....e.e....e@..@.@.e..
w.e@e.eee@e.e...e.@e@.....e..e.ee@.w
...e@e@@....e@.e@..e.e....@e@@..@e..
..ee.@@e.e...e..@e@@.@e....eee.e....
w.@@eeee.@ee@ee@eeee.e...ee@@e.@e..w
..e..e@@e...e.@ee@e..@e.e@.e..e@e...
