33,36
353
353
1000
....@e@e..ee@e..e@e..e.ee@@e.....e..
w..eee@...@e@@e....e.@.@.ee.@e.e@@.w
...@e@e...e.e....@e@eeee....e@..ee..
..e@e@e..e@......e.e@@@.....@e.e@@..
w.@@e@.e@e@.....e@.e.ee.....e...ee.w
..ee.e.@e.ee@eee@..@...e....@e..@e..
..e...e@e...e@@e@e@eee@@e....@..e...
w.@e..e@...e@e.e@...@.e.@ee..e..e..w
....e@.ee@e@e@.@e...e....e@..@e.@...
..e.ee...e.e........e@e..e@eee@.ee..
w.@e@e...e@@e.....@e.e....e@@@..e@.w
...e@@.e@ee...ee@ee@.@e.e@.@ee..@e..
...@ee.@e..e@e@@@e...@e@ee@e@.......
w...e@ee..e..@@eee...e...ee.e@e....w
..e.e@@@.e@e.ee.@@e.....e@@e@....e..
..@e@eee@@..e@..e...e.@e.@e.e@e.e@..
w.@e@...eee@ee......@ee..e..e@...e.w
..e.e.@e@..e.@.e.....e@e..e@.e.e....
.....@e....@ee.@e....@e....e..e@.e..
w....ee....e@.e@@@e@ee@@e....ee@e@.w
....e@@..e.@e.@eeee..e@e....e@@e@...
....e.e..@e@e@e@..@..@e@e..e@..e....
w.e@@e.....e@e..eee..ee@@.e@@e.@e..w
..ee@e..e@.@...e@@@ee@@eee@@e.e@ee..
..@e...e.e.e.e.e@e.@@e@e.e@e.e..e@..
w......@.@.e@@ee@e.e.e@e.....@..@..w
...@e.ee.e..ee.e@@....@e....ee.ee@..
...e.e@@e@.e@@e.eee..ee.e..e@..@.e..
w..@e@.@e@@e@e@e..@ee@.e@...@e@e...w
....@..e.ee@..e@e...@..@e@e@e.e.e@..
....e.........e@@e@ee.e@..e...@e.e..
w..ee....e.e.e@e@e.e...e..@e.......w
..e@@e..e@e@.@e...e@..e@ee@e@e......
